╔════════════════════════════╦═══╗ ╔══════╗                                                                                                                     ╔══════════════╦════╗ ╔════╦══════════════╗
║............................║...╙4╜.....W║                                                                                                                     ║.W.W.W.W.W.W..║....╙5╜....║.W.W.W.W.W.W..║
║.....TC.TC.TC.TC.TC.TC.TC...║............║                                                                                                                     ║..............║...........║..............║
║............................║............║                                                                                                                     ║..............╩...........╩..............║
║.....TC.TC.TC.TC.TC.TC.TC...║............║                                                                                                                     ║.........................................║
║............................║............║                                                                                                                     ║.........................................║
║............................╩............║                                                                                                                     ║..............╦...........╦..............║
║.........................................║                                                                                                                     ║..............║...........║..............║
║.........................................║                                                                                                                     ║..............║...........║..............║
║............................╦............║                                                                                                                     ║.K.K.K.K.K.K..║...........║.K.K.K.K.K.K..║
║.....TC.TC.TC.TC.TC.TC.TC...║............║                                                                                                                     ╠══════════════║...........║══════════════╣
║............................║............║                                                                                                                     ║..............║...........║..............║
║.....TC.TC.TC.TC.TC.TC.TC...║............║                                                                                                                     ║..............║...........║..............║
║............................║............║                                                                                                                     ║..............║...........║..............║
║.....TC.TC.TC.TC.TC.TC.TC...║............║                                                                                                                     ║..............║...........║..............║
║............................║............║                                                                                                                     ║..............║...........║..............║
║.....TC.TC.TC.TC.TC.TC.TC...║............║                                                                                                                     ║..............║BBBBBBB....║..............║
║............................║............║                                                                                                                     ║..............║...........║..............║
║............................║............║                                                                                                                     ║..............║...........║..............║
╠═══════════╣..╠═════════════╣............║                                                                                                                     ║..............║...........║..............║
║............................║............║                                                                                                                     ║..............║...........║..............║
║............................║............║                                                                                                                     ║..............║...........║..............║
║....T................T......║............║                                                                                                                     ║..............║...........║..............║
║.....T..............T.......║............║                                                                                                                     ║..............║...........║..............║
║......T............T........║............║                                                                                                                     ║..............║...........║..............║
║.......T..........T.........║............║                                                                                                                     ║..............║...........║..............║
║........T........T..........║............║                                                                                                                     ║..............║....BBBBBBB║..............║
║.........T......T...........║............║                                                                                                                     ║..............║...........║..............║
║..........TTTTTT............║............║                                                                                                                     ║..............║...........║..............║
║............................║............║                                                                                                                     ║..............║...........║..............║
║............................║............║                                                                                                                     ║..............║...........║..............║
║CCCCCCCCCCCCCCCCCCCCCCCCCCCC║............║                                                                                                                     ║..............║...........║..............║
╠════════════════════════════╣............║                                                                                                                     ║..............║...........║..............║
║..T..T..TTTT..T.....TTTT....║............║                                                                                                                     ║..............║...........║..............║
║..T..T..T.....T.....T..T....║............║                                                                                                                     ║..............║...........║..............║
║..TTTT..TTTT..T.....TTTT....║............║                                                                                                                     ║..............║...........║..............║
║..T..T..T.....T.....T.......║............║                                                                                                                     ║..............║...........║..............║
║..T..T..TTTT..TTTT..T.......║............║                                                                                                                     ║..............║BBBBBBB....║..............║
║............................║............║                                                                                                                     ║..............║...........║..............║
║............................╩............║                                                                                                                     ║..............║...........║..............║
║.........................................║                                                                                                                     ║..............║...........║..............║
║.........................................║                                                                                                                     ║..............║...........║..............║
║............................╦............║                                                                                                                     ╠══════════════╝...........╚══════════════╣
║............................║............║                                                                                                                     ║.........................................║
║....C..C..C..C..C..C..C.....║............║                                                                                                                     ║.........................................║
║............................║............║                                                                                                                     ║.........................................║
║....C..C..C..C..C..C..C.....║............║                                                                                                                     ║.........................................║
║............................║............║                                                                                                                     ║.........................................║
║....C..C..C..C..C..C..C.....║............║                                                                                                                     ║.........................................║
║............................║...........W║                                                                                                                     ║TTHTTTTPTTTTTPTTTT......TTTTPTTTPTTTTTPTT║
╠════════════════════════════╬══╣..╠══════╩═══════════════════════════════╦════════════════════════════════════════════════════════════════╦════════════════════╩═══════════════════╣..╠══════════════════╣
║............................║...........................................W║...............B.........................B......................║.............................................B................║
║....TC.TC.TC.TC.TC.TC.TC....║............................................║...............B.........................B......................║.............................................B................║
║............................║............................................║...............B.........................B......................║.....TTTTTTTTTTTTTTTTTTTTTTTTTTTTT...........B................║
║....TC.TC.TC.TC.TC.TC.TC....║............................................║...............B............B............B......................║.............................................B................║
║............................╩............................................╩...............B............B............B......................╩.............................................BBBBBBBBBB.......║
║......................................TTTTTTTTTTTTTTTTTTTTTTTTTT.........................B............B............B.............................................................................B.......║
║.........................................................................................B............B............B.............................................................................B.......║
║....TC.TC.TC.TC.TC.TC.TC....╦............................................╦...............B............B............B......................╦......................................................B.......║
║............................║T...........................................║...............B............B............B......................║......................................................BBBB....║
║....TC.TC.TC.TC.TC.TC.TC....║T...........................................║...............B............B............B......................║.....TTTTTTTTTTTTTTTTTTTTTTTTTTTTTT...........................║
║............................║H...........................................║............................B...................................║..............................................................║
║............................║T...........................................║............................B...................................║..............................................................║
║............................║TTTTTTTPTTTTTTTTPTTTTTTTTTTPTTTTTTTTTTT....W║............................B...................................║..............................................................║
╚════════════════════════════╩════════════════════════════════════════════╩════════════════════════════════════════════════════════════════╩══════════════════════════════════════════════════════════════╝