╔════════════════════════════╦═══╗ ╔══════╗                                                                                                                     ╔══════════════╦════╗ ╔════╦══════════════╗
║............................║...╙4╜.....ↁ║                                                                                                                     ║.ↁ.ↁ.ↁ.ↁ.ↁ.ↁ..║....╙5╜....║.ↁ.ↁ.ↁ.ↁ.ↁ.ↁ..║
║.....☐ᆉ.☐ᆉ.☐ᆉ.☐ᆉ.☐ᆉ.☐ᆉ.☐ᆉ...║............║                                                                                                                     ║..............║...........║..............║
║............................║............║                                                                                                                     ║..............╩...........╩..............║
║.....☐ᆉ.☐ᆉ.☐ᆉ.☐ᆉ.☐ᆉ.☐ᆉ.☐ᆉ...║............║                                                                                                                     ║.........................................║
║............................║............║                                                                                                                     ║.........................................║
║............................╩............║                                                                                                                     ║..............╦...........╦..............║
║.........................................║                                                                                                                     ║..............║...........║..............║
║.........................................║                                                                                                                     ║..............║...........║..............║
║............................╦............║                                                                                                                     ║.ꗞ.ꗞ.ꗞ.ꗞ.ꗞ.ꗞ..║...........║.ꗞ.ꗞ.ꗞ.ꗞ.ꗞ.ꗞ..║
║.....☐ᆉ.☐ᆉ.☐ᆉ.☐ᆉ.☐ᆉ.☐ᆉ.☐ᆉ...║............║                                                                                                                     ╠══════════════║...........║══════════════╣
║............................║............║                                                                                                                     ║..............║...........║..............║
║.....☐ᆉ.☐ᆉ.☐ᆉ.☐ᆉ.☐ᆉ.☐ᆉ.☐ᆉ...║............║                                                                                                                     ║..............║...........║..............║
║............................║............║                                                                                                                     ║..............║...........║..............║
║.....☐ᆉ.☐ᆉ.☐ᆉ.☐ᆉ.☐ᆉ.☐ᆉ.☐ᆉ...║............║                                                                                                                     ║..............║...........║..............║
║............................║............║                                                                                                                     ║..............║...........║..............║
║.....☐ᆉ.☐ᆉ.☐ᆉ.☐ᆉ.☐ᆉ.☐ᆉ.☐ᆉ...║............║                                                                                                                     ║..............║✖✖✖✖✖✖✖....║..............║
║............................║............║                                                                                                                     ║..............║...........║..............║
║............................║............║                                                                                                                     ║..............║...........║..............║
╠═══════════╣..╠═════════════╣............║                                                                                                                     ║..............║...........║..............║
║............................║............║                                                                                                                     ║..............║...........║..............║
║............................║............║                                                                                                                     ║..............║...........║..............║
║....☐................☐......║............║                                                                                                                     ║..............║...........║..............║
║.....☐..............☐.......║............║                                                                                                                     ║..............║...........║..............║
║......☐............☐........║............║                                                                                                                     ║..............║...........║..............║
║.......☐..........☐.........║............║                                                                                                                     ║..............║...........║..............║
║........☐........☐..........║............║                                                                                                                     ║..............║....✖✖✖✖✖✖✖║..............║
║.........☐......☐...........║............║                                                                                                                     ║..............║...........║..............║
║..........☐☐☐☐☐☐............║............║                                                                                                                     ║..............║...........║..............║
║............................║............║                                                                                                                     ║..............║...........║..............║
║............................║............║                                                                                                                     ║..............║...........║..............║
║ᆉᆉᆉᆉᆉᆉᆉᆉᆉᆉᆉᆉᆉᆉᆉᆉᆉᆉᆉᆉᆉᆉᆉᆉᆉᆉᆉᆉ║............║                                                                                                                     ║..............║...........║..............║
╠════════════════════════════╣............║                                                                                                                     ║..............║...........║..............║
║..☐..☐..☐☐☐☐..☐.....☐☐☐☐....║............║                                                                                                                     ║..............║...........║..............║
║..☐..☐..☐.....☐.....☐..☐....║............║                                                                                                                     ║..............║...........║..............║
║..☐☐☐☐..☐☐☐☐..☐.....☐☐☐☐....║............║                                                                                                                     ║..............║...........║..............║
║..☐..☐..☐.....☐.....☐.......║............║                                                                                                                     ║..............║...........║..............║
║..☐..☐..☐☐☐☐..☐☐☐☐..☐.......║............║                                                                                                                     ║..............║✖✖✖✖✖✖✖....║..............║
║............................║............║                                                                                                                     ║..............║...........║..............║
║............................╩............║                                                                                                                     ║..............║...........║..............║
║.........................................║                                                                                                                     ║..............║...........║..............║
║.........................................║                                                                                                                     ║..............║...........║..............║
║............................╦............║                                                                                                                     ╠══════════════╝...........╚══════════════╣
║............................║............║                                                                                                                     ║.........................................║
║....ᆉ..ᆉ..ᆉ..ᆉ..ᆉ..ᆉ..ᆉ.....║............║                                                                                                                     ║.........................................║
║............................║............║                                                                                                                     ║.........................................║
║....ᆉ..ᆉ..ᆉ..ᆉ..ᆉ..ᆉ..ᆉ.....║............║                                                                                                                     ║.........................................║
║............................║............║                                                                                                                     ║.........................................║
║....ᆉ..ᆉ..ᆉ..ᆉ..ᆉ..ᆉ..ᆉ.....║............║                                                                                                                     ║.........................................║
║............................║...........ↁ║                                                                                                                     ║☐☐☎☐☐☐☐✉☐☐☐☐☐✉☐☐☐☐......☐☐☐☐✉☐☐☐✉☐☐☐☐☐✉☐☐║
╠════════════════════════════╬══╣..╠══════╩═══════════════════════════════╦════════════════════════════════════════════════════════════════╦════════════════════╩═══════════════════╣..╠══════════════════╣
║............................║...........................................ↁ║...............✖.........................✖......................║.............................................✖................║
║....☐ᆉ.☐ᆉ.☐ᆉ.☐ᆉ.☐ᆉ.☐ᆉ.☐ᆉ....║............................................║...............✖.........................✖......................║.............................................✖................║
║............................║............................................║...............✖.........................✖......................║.....☐☐☐☐☐☐☐☐☐☐☐☐☐☐☐☐☐☐☐☐☐☐☐☐☐☐☐☐☐...........✖................║
║....☐ᆉ.☐ᆉ.☐ᆉ.☐ᆉ.☐ᆉ.☐ᆉ.☐ᆉ....║............................................║...............✖............✖............✖......................║.............................................✖................║
║............................╩............................................╩...............✖............✖............✖......................╩.............................................✖✖✖✖✖✖✖✖✖✖.......║
║......................................☐☐☐☐☐☐☐☐☐☐☐☐☐☐☐☐☐☐☐☐☐☐☐☐☐☐.........................✖............✖............✖.............................................................................✖.......║
║.........................................................................................✖............✖............✖.............................................................................✖.......║
║....☐ᆉ.☐ᆉ.☐ᆉ.☐ᆉ.☐ᆉ.☐ᆉ.☐ᆉ....╦............................................╦...............✖............✖............✖......................╦......................................................✖.......║
║............................║☐...........................................║...............✖............✖............✖......................║......................................................✖✖✖✖....║
║....☐ᆉ.☐ᆉ.☐ᆉ.☐ᆉ.☐ᆉ.☐ᆉ.☐ᆉ....║☐...........................................║...............✖............✖............✖......................║.....☐☐☐☐☐☐☐☐☐☐☐☐☐☐☐☐☐☐☐☐☐☐☐☐☐☐☐☐☐☐...........................║
║............................║☎...........................................║............................✖...................................║..............................................................║
║............................║☐...........................................║............................✖...................................║..............................................................║
║............................║☐☐☐☐☐☐☐✉☐☐☐☐☐☐☐☐✉☐☐☐☐☐☐☐☐☐☐✉☐☐☐☐☐☐☐☐☐☐☐....ↁ║............................✖...................................║..............................................................║
╚════════════════════════════╩════════════════════════════════════════════╩════════════════════════════════════════════════════════════════╩══════════════════════════════════════════════════════════════╝