╔════════════════════════════════════════════╦═════════════════════════════════════════════════════════════════════════════════════════════════════════╗                                                                                                            
║............................................║                                                                                                         ║
║..|▀|▀|▀|▀|..........|▀|▀|▀|▀|..............║                                                                                                         ║
║..☐☐☐☐☐☐☐☐☐..........☐☐☐☐☐☐☐☐☐..............║                                                                                                         ║
║..☐☐☐☐☐☐☐☐☐..........☐☐☐☐☐☐☐☐☐..............║                                                                                                         ║
║..|▀|▀|▀|▀|..........|▀|▀|▀|▀|..............║---------------------------------------------------------------------------------------------------------║
║............................................║.........................................................................................................║
║............................................║.........................................................................................................║
║............................................║.........................................................................................................║
║............................................╩.........................................................................................................║
║..|▀|▀|▀|▀|..........|▀|▀|▀|▀|......................................................................................................................✖✖╩
║..☐☐☐☐☐☐☐☐☐..........☐☐☐☐☐☐☐☐☐......................................................................................................................✖✖ 
║..☐☐☐☐☐☐☐☐☐..........☐☐☐☐☐☐☐☐☐..............╦.......................................................................................................✖✖╦
║..|▀|▀|▀|▀|..........|▀|▀|▀|▀|..............║.....................................................................................................✖✖✖ ║
║............................................║---------------------\......./--------------------|.........|--------------------------------------------║
║..|▀|▀|▀|▀|..........|▀|▀|▀|▀|..............║                      \...../                     |.........|                                            ║
║..☐☐☐☐☐☐☐☐☐..........☐☐☐☐☐☐☐☐☐..............║                       \.../                      |.........|                                            ║
║..☐☐☐☐☐☐☐☐☐..........☐☐☐☐☐☐☐☐☐..............║                        \-/                       |.........|                                            ║
║..|▀|▀|▀|▀|..........|▀|▀|▀|▀|..............║                                                  |.........|                                            ║
║............................................║                                                  |.........|                                            ║
║..|▀|▀|▀|▀|..........|▀|▀|▀|▀|..............╚═════════════════════════════════════════════════════════════════════════════════════════════════════════╣
║..☐☐☐☐☐☐☐☐☐..........☐☐☐☐☐☐☐☐☐.........................................................✖...✖.✖                                                        ║
║..☐☐☐☐☐☐☐☐☐..........☐☐☐☐☐☐☐☐☐..................|▀|▀|▀|............|▀|▀|▀|..........✖......✖✖.✖                                                       ║
║..|▀|▀|▀|▀|..........|▀|▀|▀|▀|................|▀|☐☐☐☐☐|▀|........|▀|☐☐☐☐☐|▀|.........✖........✖✖                                                      ║
║..............................................|▀|☐☐☐☐☐|▀|........|▀|☐☐☐☐☐|▀|.................✖..✖                                                     ║  
║..|▀|▀|▀|▀|..........|▀|▀|▀|▀|..................|▀|▀|▀|............|▀|▀|▀|....................✖.✖                                                     ║
║..☐☐☐☐☐☐☐☐☐..........☐☐☐☐☐☐☐☐☐.........................................................✖......✖✖.✖                                                    ║
║..☐☐☐☐☐☐☐☐☐..........☐☐☐☐☐☐☐☐☐..................................................................✖✖✖✖                                                  ║
║..|▀|▀|▀|▀|..........|▀|▀|▀|▀|..................|▀|▀|▀|............|▀|▀|▀|.........................✖                                                  ║
║..............................................|▀|☐☐☐☐☐|▀|........|▀|☐☐☐☐☐|▀|..............✖.....✖..✖                                                  ║
║..............................................|▀|☐☐☐☐☐|▀|........|▀|☐☐☐☐☐|▀|...................✖✖.✖✖                                                  ║
║................................................|▀|▀|▀|............|▀|▀|▀|......................✖✖✖✖                                                  ║
║.......................................╔7╗..................................................✖......✖                                                  ║
╚═══════════════════════════════════════╝ ╚════════════════════════════════════════════════════════════════════════════════════════════════════════════╝