╔═══════════════════════════════════════════════════════════════════════════╦═══════════════════════════╦════════════════════════════════════╗
║..............✖............................................................║ↁ.........................ↁ╩....................................║
║..............✖............................................................║................................................................║
║..............✖............................................................║..............✖.................................................║
║..............✖......................................☐.....................║..............✖............╦...☐ᆉ..☐ᆉ..☐ᆉ..☐ᆉ..☐ᆉ..☐ᆉ..☐ᆉ..☐ᆉ...║
║..............✖......................................☐.....................║..............✖............║....................................║
║..............✖......................................☐☐☐☐☐☐☐☐..............║..............✖............║....................................║
║..............✖.............................................☐..............║..............✖............║...☐ᆉ..☐ᆉ..☐ᆉ..☐ᆉ..☐ᆉ..☐ᆉ..☐ᆉ..☐ᆉ...║
║..............✖...............✖✖✖✖✖✖✖✖✖✖✖✖✖.................☐..............║..............✖............║....................................║
║..............✖..............✖..............................☐..............║..............✖............║....................................║
║..............✖.............✖...............................☐..............║....✖✖✖✖✖✖✖✖✖✖✖✖✖✖✖✖✖✖✖....║...☐ᆉ..☐ᆉ..☐ᆉ..☐ᆉ..☐ᆉ..☐ᆉ..☐ᆉ..☐ᆉ...║
║..............✖............✖...................✖✖✖✖✖✖✖✖✖✖✖✖✖✖..............║..............✖............║....................................║
║..............✖...........✖....................✖...........................║..............✖............║....................................║
║..........................✖....................✖...........................║..............✖............║...☐ᆉ..☐ᆉ..☐ᆉ..☐ᆉ..☐ᆉ..☐ᆉ..☐ᆉ..☐ᆉ...║
║..........................✖.....................✖..........................║..............✖............║....................................║
║..........................✖......................✖.........................║..............✖............║....................................║
║✖✖✖✖✖✖✖✖✖✖✖✖✖✖✖✖✖✖✖✖✖✖✖✖✖✖✖.......................✖........................╩..............✖............║...☐ᆉ..☐ᆉ..☐ᆉ..☐ᆉ..☐ᆉ..☐ᆉ..☐ᆉ..☐ᆉ...║
║...................................................✖......................................✖............║....................................║
║....................................................✖..................................................║....................................║
║.....................................................✖.....................╦ↁ.........................ↁ║...☐ᆉ..☐ᆉ..☐ᆉ..☐ᆉ..☐ᆉ..☐ᆉ..☐ᆉ..☐ᆉ...║
╠══════╣..╠═════════════════════════════════════════════════════════════════╬═══════════════════════════╣....................................║
║...........................................................................║ꗞ.ꗞ.ꗞ.ꗞ.ꗞ.ꗞ.ꗞ.ꗞ.ꗞ.ꗞ.ꗞ.ꗞ.ꗞ.ꗞ║....................................║
║................☐☐☐☐☐.....☐......☐...☐.....................................╩...........................║...☐ᆉ..☐ᆉ..☐ᆉ..☐ᆉ..☐ᆉ..☐ᆉ..☐ᆉ..☐ᆉ...║
║................☐........☐.☐.....☐...☐.................................................................║....................................║
║................☐☐☐☐☐...☐☐☐☐☐....☐...☐.................................................................║....................................║
║................☐......☐.....☐...☐...☐☐☐☐☐☐................................╦...........................║...☐ᆉ..☐ᆉ..☐ᆉ..☐ᆉ..☐ᆉ..☐ᆉ..☐ᆉ..☐ᆉ...║
║...........................................................................║ↁ.ↁ.ↁ.ↁ.ↁ.ↁ.ↁ.ↁ.....ↁ.ↁ.ↁ.ↁ║....................................║
╠═══════════════════════════════════════════════════════════════════════════╬═══════════════╣..╠════════╬════════════════════════════════════╣
║...........................................................................║ↁ.........................ↁ║...................✖................║
║..................✖.............................✖..........................║...........................║...................✖................║
║.......✖✖✖✖✖✖✖✖✖✖✖✖.............................✖✖✖✖✖✖✖✖✖✖✖✖✖✖✖✖✖..........║...........................║...................✖................║
║..................✖.............................✖..........................║...........................║...................✖................║
║..................✖.............................✖..........................║...........................║....................................║
║..................✖✖✖✖✖✖✖✖✖✖✖✖✖✖✖✖✖✖✖✖✖✖✖✖✖✖✖✖✖✖✖..........................║...........................║....................................║
║..................................✖........................................║...........................║..........✖✖✖✖✖✖✖✖✖✖✖✖✖✖✖✖✖✖✖✖✖✖✖✖✖✖║
║..................................✖........................................║...........................║....................................║
║......☐☐☐☐☐☐☐☐☐☐☐☐☐☐☐☐............✖.............☐☐☐☐☐☐☐☐☐☐☐☐☐☐☐☐...........║....☐☐☐☐☐☐☐☐☐☎☐☐☐☐☐☐☐☐☐....║....................................║
║..................................✖........................................║...........................║....................................║
║..................................✖..................................╔═════╣...........................║....................................║
║.................................✖.✖.................................╝|||||║...........................║✖✖✖✖✖✖✖✖✖✖✖✖✖✖✖✖✖✖✖✖✖✖✖✖✖...........║
║................................✖...✖...............................1 |||||║...........................║....................................║
║...............................✖.....✖...............................╗|||||║...........................║....................................║
║..............................✖.......✖..............................╚═════╣...........................╩....................................║
║.............................✖.........✖...................................║................................................................║
║...........................................................................║................................................................║
║...........................................................................║ↁ.........................ↁ╦....................................║
╠══════╣..╠═════════════════════════════════════════════════════════════════╬══╣..╠═════════════════════╬══════╦═══╦═════════════════════════╣
║............................☐☐☐............................................║☐......☐☐☐☐☎☐☐☐☐☐✉☐☐☐☐☐✉☐☐☐║......║---║.........................║
║...........................................................................║☎.........................☐║......║---║.........................║
║......................................................☐☎☐..................║☐.........................✉║......║---║.........................║
║...........................................................................║☐.........................☐║......╚╗2╔╝.........................║
║..........☐☐☐............................☐☐☐...............................║☐..........................║....................................║
║...........................................................................║☎.........................✖║....................................║
║..............................................................☐☐☐..........║☐........................✖.╩....................................║
║.....................☐☐☐...................................................║☐.......................✖.......................................║
║...........................................................................║☐......................✖........................................║
║....☐✉☐....................................................................╩......................✖....╦════════════════════════════════════╝
║..............................................☐☐☐................................................✖.....║
║................................................................................................✖......║
║...........☐☐☐.............................................................╦....................✖......║
║...............................☐✉☐.........................................║✖✖✖✖✖✖✖✖✖✖✖✖✖✖......✖......║
║...............................................................☐✉☐.........║....................✖......║
║...........................................................................║....................✖......║
║........☐☐☐.........................☐☐☐....................................║.....✖✖✖✖✖✖✖✖✖✖✖✖✖✖✖✖......║
║...........................................................................║...........................║
║...................................................☐☐☐.....................║...........................║
╚═══════════════════════════════════════════════════════════════════════════╩═══════════════════════════╝