╔═══════════════════════════════════════════════════════════════════════════╦═══════════════════════════╦════════════════════════════════════╗                
║......|▀|▀|▀|▀|▀|▀|▀|▀|▀|▀|▀|▀|▀|▀|▀|▀|▀|▀|▀|▀|▀|▀|▀|▀|▀|▀|▀|..............║☐☐☐☐☐☐☎☐☐☐☐☐✉☐☐☐☐☐☐✉☐☐☐☐☐☐☐╩....................................║
║...........................................................................║.................................☐ᆉ☐ᆉ☐ᆉ☐ᆉ☐ᆉ☐ᆉ☐ᆉ☐ᆉ☐ᆉ☐ᆉ☐ᆉ☐ᆉ☐ᆉ☐....║
║......|▀|▀|▀|▀|▀|▀|▀|▀|▀|▀|▀|▀|▀|▀|▀|▀|▀|▀|▀|▀|▀|▀|▀|▀|▀|▀|▀|..............║................................................................║
║...........................................................................║...........................╦.....☐ᆉ☐ᆉ☐ᆉ☐ᆉ☐ᆉ☐ᆉ☐ᆉ☐ᆉ☐ᆉ☐ᆉ☐ᆉ☐ᆉ☐ᆉ☐....║
║......|▀|▀|▀|▀|▀|▀|▀|▀|▀|▀|▀|▀|▀|▀|▀|▀|▀|▀|▀|▀|▀|▀|▀|▀|▀|▀|▀|..............║...........................║....................................║
║...........................................................................║...........................║.....☐ᆉ☐ᆉ☐ᆉ☐ᆉ☐ᆉ☐ᆉ☐ᆉ☐ᆉ☐ᆉ☐ᆉ☐ᆉ☐ᆉ☐ᆉ☐....║
║......|▀|▀|▀|▀|▀|▀|▀|▀|▀|▀|▀|▀|▀|▀|▀|▀|▀|▀|▀|▀|▀|▀|▀|▀|▀|▀|▀|..............║...........................║....................................║
║...........................................................................║✖✖✖✖✖✖✖✖✖✖✖✖✖✖✖✖✖✖✖........║....................................║
║........|▀|▀|▀|▀|▀|▀|▀|▀|▀|▀|▀|▀|▀|▀|▀|▀|▀|▀|▀|▀|▀|▀|▀|▀|▀|................║...........................║.....☐ᆉ☐ᆉ☐ᆉ☐ᆉ☐ᆉ☐ᆉ☐ᆉ☐ᆉ☐ᆉ☐ᆉ☐ᆉ☐ᆉ☐ᆉ☐....║
║...........................................................................║...........................║....................................║
║..........|▀|▀|▀|▀|▀|▀|▀|▀|▀|▀|▀|▀|▀|▀|▀|▀|▀|▀|▀|▀|▀|▀|▀|..................║...........................║.....☐ᆉ☐ᆉ☐ᆉ☐ᆉ☐ᆉ☐ᆉ☐ᆉ☐ᆉ☐ᆉ☐ᆉ☐ᆉ☐ᆉ☐ᆉ☐....║
║...........................................................................║.....✖✖✖✖✖✖✖✖✖✖✖✖✖✖✖✖✖✖✖✖✖✖║....................................║
║............|▀|▀|▀|▀|▀|▀|▀|▀|▀|▀|▀|▀|▀|▀|▀|▀|▀|▀|▀|▀|▀|....................║...........................║.....☐ᆉ☐ᆉ☐ᆉ☐ᆉ☐ᆉ☐ᆉ☐ᆉ☐ᆉ☐ᆉ☐ᆉ☐ᆉ☐ᆉ☐ᆉ☐....║
║...........................................................................║...........................║....................................║
║..............|▀|▀|▀|▀|▀|▀|▀|▀|▀|▀|▀|▀|▀|▀|▀|▀|▀|▀|▀|......................║...........................║....................................║
║...........................................................................║...........................║.....☐ᆉ☐ᆉ☐ᆉ☐ᆉ☐ᆉ☐ᆉ☐ᆉ☐ᆉ☐ᆉ☐ᆉ☐ᆉ☐ᆉ☐ᆉ☐....║
║................|▀|▀|▀|▀|▀|▀|▀|▀|▀|▀|▀|▀|▀|▀|▀|▀|▀|........................║...........................║....................................║
║...........................................................................║☐☐☐☐☐☐☐☐☐☐☐☐☐☐☐☐☐..........║.....☐ᆉ☐ᆉ☐ᆉ☐ᆉ☐ᆉ☐ᆉ☐ᆉ☐ᆉ☐ᆉ☐ᆉ☐ᆉ☐ᆉ☐ᆉ☐....║
║..................|▀|▀|▀|▀|▀|▀|▀|▀|▀|▀|▀|▀|▀|▀|▀|..........................║...........................║....................................║
║...........................................................................║...........................║.....☐ᆉ☐ᆉ☐ᆉ☐ᆉ☐ᆉ☐ᆉ☐ᆉ☐ᆉ☐ᆉ☐ᆉ☐ᆉ☐ᆉ☐ᆉ☐....║
║.....................|▀|▀|▀|▀|▀|▀|▀|▀|▀|▀|▀|▀|.............................║..ᆉ........................║....................................║
║...........................................................................╩...........................║....................................║
║.......................|▀|▀|▀|▀|▀|▀|▀|▀|▀|▀|...........................................................║....................................║
║.......................................................................................ᆉ.............ᆉ.║....................................║
║...........................................................................╦...........................║....................................║
║ↁ.........................................................................ↁ║.........ᆉ.................║ↁ..................................ↁ║
╠═╣..╠══════════════════════════════════════════════════════════════════════╬═══════════════╣..╠════════╬═════════════════════════╣..╠═══════╣
║..........✖................................................................║ↁ.........................ↁ║☐☐☐☐✉☐☐☐☐☐☐☐☐☐☐☐☐☐✉☐☐☐☐☐☐...........║
║..........✖................................................................║...........................║☐...................................║
║..........✖...................................✖............................║...........................║☐...................................║
║..........✖..................................✖.............................║...........................║☐...................................║
║..........✖.................................✖..............................║...........................║☐☐☐☐☐☐☐☐☎☐☐☐☐☐☐☐☐✉☐☐☐☐☐☐☐...........║
║..........✖................................✖...............................║...........................║☐...................................║
║..........✖✖✖✖✖✖✖✖✖✖✖✖✖✖✖✖✖✖✖✖✖✖✖✖✖✖✖✖✖✖✖✖✖✖✖✖✖✖✖..........................║...........................║☐...................................║
║..........✖................................✖...............................║...........................║☐...................................║
║..........✖.................................✖..............................║...........................║☐☐☐☐☐✉☐☐☐☐☐✉☐☐☐☐☐☐☐☐✉☐☐☐☐...........║
║..........✖..................................✖.............................║✖✖✖✖✖✖✖✖✖✖✖✖...✖✖✖✖✖✖✖✖✖✖✖✖║☐...................................║
║..........✖......................☐............✖......................╔═════╣...........................║☐...................................║
║..........✖......................☐...................................╝|||||║...........................║☐...................................║
║.................................☐...................................2|||||║...........................║☐☐☐☐☐☐☐☐☐☐☐☐☐☐☐☐☐☐☐☐☐☐☐☐☐...........║
║.................................☐...................................╗|||||║...........................║☐...................................║
║.................................☐...................................╚═════╣...........................║☐...................................║
║.................................☐.........................................║...........................║☐.............✖✖✖✖✖✖✖✖✖✖✖✖✖✖✖✖✖✖✖✖✖✖║
║.................................☐.........................................║...........................║☐...................................║
║.................................☐.........................................║ↁ.........................ↁ║☐...................................║
╠═══════════════════════════════════════════════════════════════════════════╬══╣..╠═════════════════════╬════╣..╠════════════════════════════╣
║...........................................................................║...........................║ↁ........ↁ.ↁ.ↁ.ↁ.ↁ.ↁ.ↁ.ↁ.ↁ..✖......ꗞ║
║...........................................................................║...........................║............................✖.......║
║.......................✖...................................................║...........................║ↁ...........................✖......ꗞ║
║......................✖....................................................║✖✖✖✖✖✖✖✖✖✖✖✖✖✖✖✖✖✖✖........║............................✖.......║
║.....................✖.....................................................║...........................║ↁ...........................✖......ꗞ║
║.....................✖.....................................................║...........................╩..............✖✖✖✖✖✖✖✖✖✖✖✖✖✖✖.......║
║.....................✖.....................................................║...............................................................ꗞ║
║.....................✖.....................................................║................................................................║
║....................✖......................................................║...........................╦..............ꗞ.ꗞ.ꗞ.ꗞ.ꗞ.ꗞ.ꗞ.ꗞ.ꗞ.ꗞ..ꗞ║
║...................✖.......................................................╩...........................╠════════════════════════════════════╝
║..................✖....................................................................................║
║✖✖✖✖✖✖✖✖✖✖✖✖✖✖✖✖✖✖.....................................................................................║
║...........................................................................╦...........................║
║...............................................................✖✖✖✖✖✖✖✖✖✖✖✖║☐.........................☐║
║..............................................................✖............║☐.........................☐║
║.............................................................✖.............║☐.........................☐║
║.............................................................✖.............║☐.........................☐║
║.................................................✖✖✖✖✖✖✖✖✖✖✖✖✖.............║☐.........................☐║
║.......................................╔1╗.................................║☐☐☐☐☐☐✉☐☐☐☐☐☐☎☐☐☐☐☐☐☐✉☐☐☐☐☐║
╚═══════════════════════════════════════╝ ╚═════════════════════════════════╩═══════════════════════════╝