╔══════════════════════════════╦═════════════════════╦═══════════════════════╦═══════════════════════════════════════╗
║..............................║ꗞ.ꗞ.ꗞ.ꗞ.ꗞ.ꗞ.ꗞ.ꗞ.ꗞ.ꗞ.ꗞ║ꗞ.ꗞ.ꗞ.ꗞ.ꗞ.ꗞ.ꗞ.ꗞ.ꗞ.ꗞ.ꗞ.ꗞ║......✖................................║
║.....☐☐☐☐☐☐☐☐☐☐☐☐☐☐...........║.....................║.......................║......✖................................║
║....☐..☐☐.....☐☐..............║.....................║.......................║......✖....☐☐☐☐☐☐☐☐☐☐☐☐☐☐☐☐☐☐☎☐☐☐☐☐☐☐☐☐║
║.......☐☐.....☐☐..............║......═══════════════╬════════════════.......║......✖................................║
║.......☐☐.....☐☐..............║....................ↁ║ↁ......................║......✖................................║
║.......☐☐.....☐☐..............║....................ↁ║ↁ......................║......✖....☐☐☐☐☐☐☐☐☐☎☐☐☐☐☐☐☐☐☐☐☐☐☐☐☐☐☐☐║
║.......☐☐.....☐☐..............║....................ↁ║ↁ......................║.......................................║
║..............................║....................ↁ║ↁ......................║.......................................║
║..................╔═══════════╩═════════╣..╠════════╩══════════╣..╠═════════╩═══════════════════╗...................║
║..................║ↁ...........................✖...............................................ↁ║...................║
║..................║............................✖................................................╩...................║
║.....✖✖✖✖✖✖✖✖✖✖✖✖✖║............................✖.....✖..............................................................║
║..................║............................✖.....✖..............................................................║
║..................╩..................................✖..........................................╦☐☐✉☐☐☐☐✉☐☐☐☐☐☐☐✉☐☐☐║
║.....................................................✖..........................................╠═══════════════════╣
║...............................╔═══════════════════════════════════════════════════╗............║..☐...☐☐☐☐☐☐☐☐☐☐☐☐☐║
║..................╦............║;;;;;;;;;;;;;;;;;;;;;;;;;;;;;;;;;;;;;;;;;;;;;;;;;;;║............║..☐................║
║..................║............║;;;;;;;;❀;;;;;;;;;;;;;;;;;;❀;;;;;;;;;;;;;;;;;;;;;;;║............║..☐................║
║ᆉᆉᆉᆉᆉᆉᆉᆉᆉᆉᆉᆉᆉᆉᆉᆉᆉᆉ║............║;;;;;;;;;;;;;;;;;;;;;;;;;;;;;;;;;;;;;;;;;;;;;;;;;;;║............║..☐................║
╠══════════════════╣............║;;;;;;;;;;;;;;;;;;;;;;;;;;;;;;;;;;;;;;;;❀;;;;;;;;;;║............║..☐................║
║☐☐☐☐☐☐☐☐☐☐☐☐☐☐☐☐☐☐║............║;;;;;;;;;;;;;;❀;;;;;;;;;;;;;;;;;;;;;;;;;;;;;;;;;;;;║............║..☐....☐☐☐☐☐☐☐☐☐☐☐☐║
║☐................☐║............║;;;;;;;;;;;;;;;;;;;;;;;;;;;;;;;;;;;;;;;;;;;;;;;;;;;║............╩...................║
║☐................☐║....✖✖✖✖✖✖✖✖║;;;;;;;;;;;;;;;;;;;;;;;;;;;;;;;;❀;;;;;;;;;;;;;;;;;;║................................║
║☐................☐║............║;;;;;;;;;;;;;;;;;;;;;;;;;;;;;;;;;;;;;;;;;;;;;;;;;;;║................................║
║☐................☐║............║;;;;;;;;;;;;;;;;;;;;;;;;;;;;;;;;;;;;;;;;;;;;;;;;;;;║............╦...................║
║☐.................╩............║;;;;;;;;;;;;;;;;;;❀;;;;;;❀;;;;;;;;;;;;;;;;;;;;;;;;;║............║..☐....☐☐☐☐☐☐☐☐☐☐☐☐║
║☐..............................║;;;;❀;;;;;;;;;;;;;;;;;;;;;;;;;;;;;;;;;;;;;;;;;;;;;;║✖✖✖✖✖✖✖✖....║..☐................║
║☐..............................║;;;;;;;;;;;;;;;;;;;;;;;;;;;;;;;;;;;;;;;;;;;;❀;;;;;;║............║..☐................║
║☐.................╦............║;;;;;;;;;;;;;;;;;;;;;;;;;;;;;;;;;;;;;;;;;;;;;;;;;;;║............║..☐................║
║☐.................║............║;;;;;;;;;;;;;;;;;;;;;;;;;;;;;;;;;;;;;;;;;;;;;;;;;;;║............║..☐................║
║☐.................║............║;;;;;;;;;;❀;;;;;;;;;;;;;;;;;;;;;;;;;;;;;;;;;;;;;;;;║............║..☐....☐☐☐☐☐☐☐☐☐☐☐☐║
║☐.................║............║;;;;;;;;;;;;;;;;;;;;;;;;;;;;;;;;;;;;;;;;❀;;;;;;;;;;║............╠═══════════════════╣
║☐.................║............║;;;;;;;;;;;;;;;;;;;;;;;;;;;;;;;;;;;;;;;;;;;;;;;;;;;║............║...................║
║☐...✖✖✖✖✖✖✖✖✖✖✖✖✖✖║............║;;;;;;;;;;;;;;;;;;;;;;;;;;;;;;;;;;;;;;;;;;;;;;;;;;;║............╩...................║
║☐.................║............║................................;;;;;;;;;;;;;;;;;;;║......................✖.........║
║☐.................║............║................................;;;;;;;;;;;;;;;;;;;║......................✖.........║
║☐.................║............║................................;;;;;;;;;;❀;;;;;;;;║............╦.........✖.........║
║☐☐☐☐☐☐☐☐☐☐☐☐☐☐☐☐☐☐║...........ↁ║................................;;;;;;;;;;;;;;;;;;;║...........ↁ║.........✖.........║
╠══════════════════╩═══╣..╠═════╩════════╣..╠══════╦══════════════════════════╗═╔═══╩══╣..╠═╦════╝.........✖✖✖✖✖✖✖✖✖✖║
║......ᆉ☐☐ᆉ......................................ᆉ☐║...............☐..........╙2╜...........║........................║
║............................ᆉ☐☐ᆉ................ᆉ☐║................☐.......................║........................║
║................................................ᆉ☐║.................☐......................║...☐☐☐☐☐☐☐☐☐☐☐☐☐☐☐☐☐☐...║
║..............ᆉ☐☐ᆉ...................ᆉ☐☐ᆉ.......ᆉ☐║..................☐.....................║...ᆉᆉᆉᆉᆉᆉᆉᆉᆉᆉᆉᆉᆉᆉᆉᆉᆉᆉ...║
║..................................................╩...................☐....................║........................║
║..........................ᆉ☐☐5.........................................☐...................║........................║
║........................................................................☐..................║...☐☐☐☐☐☐☐☐☐☐☐☐☐☐☐☐☐☐...║
║.............☐....................................╦......................☐✖✖✖✖✖✖✖✖✖✖✖✖✖✖✖✖✖║...ᆉᆉᆉᆉᆉᆉᆉᆉᆉᆉᆉᆉᆉᆉᆉᆉᆉᆉ...║
║.............☐....................................║........................................║........................║
║.............☐...............................☐...ᆉ║........................................║........................║
║.............☐...............................☐...ᆉ║........................................║...☐☐☐☐☐☐☐☐☐☐☐☐☐☐☐☐☐☐...║
║.............☐....................................║........................................║...ᆉᆉᆉᆉᆉᆉᆉᆉᆉᆉᆉᆉᆉᆉᆉᆉᆉᆉ...║
║.............☐....................................║........................................║........................║
║.............☐...............................☐...ᆉ║........................................║........................║
║.............☐...............................☐...ᆉ║......╓1╖........34.....................║...☐☐☐☐☐☐☐☐☐☐☐☐☐☐☐☐☐☐...║
╚══════════════════════════════════════════════════╩══════╝ ╚═══════════════════════════════╩════════════════════════╝
