╔════════════════════╦═════════════════════════════════╦═══════════════════════╦═════════════════════════════════════╗
║ↁ..................ↁ║☐☐☐☐☐☐☎☐☐☐☐☐☐☐☐☐☐☐☐☐☐☐☎☐☐☐☐☐☐☐☐☐☐║.......................╩.....................................║
║....................║.................................║............☐................................................║
║..☐ᆉ☐ᆉ☐ᆉ☐ᆉ☐ᆉ☐ᆉ☐ᆉ☐...║.................................║............☐................................................║
║....................║.................................╩......☐☐☐☐☐☐☐..........╦.....................................║
║....................║..............................................☐..........║.....................................║
║..☐ᆉ☐ᆉ☐ᆉ☐ᆉ☐ᆉ☐ᆉ☐ᆉ☐...║..............................................☐..........║.....................................║
║....................║.................................╦............☐..........║.....................................║
║....................║..............☐☐✉☐☐☐☐✉☐☐☐☐☐☐✉☐☐☐☐║.......................║.....................................║
║..☐ᆉ☐ᆉ☐ᆉ☐ᆉ☐ᆉ☐ᆉ☐ᆉ☐...╠═════════╣..╠════════════════════╩═══════════════════════╩════════════════╗....................║
║....................║ↁ............................✖...........✖...............................ↁ╩....................║
║....................║.............................✖...........✖.....................................................║
║..☐ᆉ☐ᆉ☐ᆉ☐ᆉ☐ᆉ☐ᆉ☐ᆉ☐...║.................✖...........✖...........✖.....................................................║
║....................║.................✖...........✖...........✖................................╦....................║
║....................║.................✖.......................✖................................╠════════════════════╣
║....................╩.................✖.......................✖................................║....................║
║...............................╔═══════════════════════════════════════════════════╗...........║..........☐.........║
║...............................║                                                   ║...........║..........☐.........║
║..☐ᆉ☐ᆉ☐ᆉ☐ᆉ☐ᆉ☐ᆉ☐ᆉ☐...╦..........║                                                   ║...........║.......☐☐☐☐☐☐☐......║
║....................║..........║                                                   ║...........╩..........☐.........║
║....................║..........║                                                   ║......................☐.........║
║..☐ᆉ☐ᆉ☐ᆉ☐ᆉ☐ᆉ☐ᆉ☐ᆉ☐...║..........║                                                   ║................................║
║....................║..........║                                                   ║...........╦....................║
╠════════════════════╣..........║                                                   ║...........║....................║
║....................║..........║                                                   ║...........║........☐☐☐☐☐☐......║
║....☐☐☐☐☐☐☐☐☐☐☐☐....║..........║                                                   ║...........║....................║
║....☐..........☐....║..........║                                                   ║...........║....................║
║.☐..☐...............║..........║                                                   ║...........╠════════════════════╣
║..☐.☐...............║..........║                                                   ║...........║ꗞ.ꗞ.ꗞ.ꗞ.ꗞ.ꗞ.ꗞ.ꗞ.ꗞ.ꗞ.║
║...☐☐...............╩..........║                                                   ║...........║....................║
║....☐..........................║                                                   ║...........║....................║
║...............................║                                                   ║...........║....................║
║....................╦..........║                                                   ║...........╩....................║
║....................║..........║                                                   ║................................║
║....................║..........║                                                   ║................................║
║....................║..........║                                                   ║...........╦....................║
║☐☐✉☐☐☐☐☐☐✉☐☐☐☐☐☐☎☐☐☐║..........║                                                   ║...........║....................║
╠════════════════════╣..........║                                                   ║...........║....................║
║ꗞ.ꗞ.ꗞ.ꗞ.ꗞ.ꗞ.ꗞ.ꗞ.ꗞ.ꗞ.║..........║                                                   ║....╓2╖....║ↁ.ↁ.ↁ.ↁ.ↁ.ↁ.ↁ.ↁ.ↁ.ↁ.║
║....................║..........╚═════════════════════════════════════════════╗═╔═══╩════╝═╚════╬════════════════════╣
║....................║........................................................╙1╜...............║....................║
║....................║..........................................................................║....................║
║....................║..........................................................................║....................║
║....................║..........................................................................║....................║
║....................║..........................................................................║....................║
║ↁ.ↁ.ↁ......ↁ.ↁ.ↁ.ↁ.ↁ║ↁ........................................................................ↁ║....................║
╠══════╣..╠══════════╩════════╣..╠═══════════════════════╦══════════════════════════════╦═══════╝✖✖✖✖✖✖✖✖✖✖✖✖✖.......║
║.................✖......................................║........☐.....................║............................║
║.................✖......................................║........☐.....................║............................║
║.................✖......................................╩........☐.....................╩............................║
║.................✖...............................................☐................................✖.................║
║.................✖...............................................☐................................✖.................║
║........................................................╦..............................╦..........✖.................║
║........................................................║..............................║..........✖.................║
║............................☐☐☐☐☐☐✉☐☐☐☐☐☐☎☐☐☐☐☐.........║..............................║..........✖.................║
╚════════════════════════════════════════════════════════╩══════════════════════════════╩════════════════════════════╝