╔═══════════════════════╦═════════════════╗                                                                   ╔ ╗                                                                ╔═════════════════════╦═══════════════════╗                                                                                                                                                                                                                    
║ↁ❖❖❖❖❖❖❖❖❖❖❖❖❖❖❖❖❖❖❖❖❖❖║❖❖❖❖❖❖❖❖❖☐☐☐✉☐✉☐☐║                                  ╔════════════════════════════════╝ ╚═══════════════════════════════╗                                ║❖❖☐☐✉☐☐☐☐☐☐✉☐☐☐☐☐✉☐☐❖❖║❖❖❖❖❖❖❖❖❖❖❖❖❖❖❖❖❖❖❖║
║❖❖❖☐ᆉ❖☐ᆉ❖☐ᆉ❖☐ᆉ❖☐ᆉ❖☐ᆉ❖❖❖║❖❖❖❖❖❖❖❖❖❖❖❖❖❖❖❖❖║                                  ║❖❖❖❖❖❖❖❖❖❖❖❖❖❖❖❖❖❖❖❖❖❖❖❖❖❖❖❖❖❖❖❖❖❖❖❖❖❖❖❖❖❖❖❖❖❖❖❖❖❖❖❖❖❖❖❖❖❖❖❖❖❖❖❖❖❖║                                ║❖❖❖❖❖❖❖❖❖❖❖❖❖❖❖❖❖❖❖❖❖║ↁ❖❖❖❖❖❖❖❖❖❖❖❖❖❖❖❖❖ꗞ║
║❖❖❖❖❖❖❖❖❖❖❖❖❖❖❖❖❖❖❖❖❖❖❖║✖❖❖❖❖❖❖❖❖❖❖❖❖❖❖❖❖║                                  ║❖❖❖❖❖❖❖❖❖❖❖❖❖❖❖❖❖❖❖❖❖❖❖❖❖❖❖❖❖❖❖❖❖❖❖❖❖❖❖❖❖❖❖❖❖❖❖❖❖❖❖❖❖❖❖❖❖❖❖❖❖❖❖❖❖❖║                                ║❖❖❖❖❖❖❖❖❖❖❖❖❖❖❖❖❖❖❖❖❖║❖❖❖❖❖❖❖❖❖❖❖❖❖❖❖❖❖❖❖║
║❖❖❖☐ᆉ❖☐ᆉ❖☐ᆉ❖☐ᆉ❖☐ᆉ❖☐ᆉ❖❖❖║❖✖❖❖❖❖❖❖❖❖❖❖❖❖❖❖❖║                                  ║❖❖❖❖❖|▀|▀|▀|▀|▀|▀|▀|▀|▀|▀|▀|▀|▀|▀|▀|▀|▀|▀|▀|▀|▀|▀|▀|▀|▀|▀|▀|❖❖❖❖❖❖║                                ║❖❖❖❖❖❖❖❖❖❖❖❖❖❖❖❖❖❖❖❖❖║ↁ❖❖❖❖❖❖❖❖❖❖❖❖❖❖❖❖❖ꗞ║
║❖❖❖❖❖❖❖❖❖❖❖❖❖❖❖❖❖❖❖❖❖❖❖║❖❖❖✖❖❖❖❖❖❖❖❖❖❖❖❖❖║                                  ║❖❖❖❖❖❖❖❖❖❖❖❖❖❖❖❖❖❖❖❖❖❖❖❖❖❖❖❖❖❖❖❖❖❖❖❖❖❖❖❖❖❖❖❖❖❖❖❖❖❖❖❖❖❖❖❖❖❖❖❖❖❖❖❖❖❖║                                ║❖❖❖❖❖❖❖❖❖❖❖❖❖❖❖❖❖❖❖❖❖║❖❖❖❖❖❖❖❖❖❖❖❖❖❖❖❖❖❖❖║
║❖❖❖☐ᆉ❖☐ᆉ❖☐ᆉ❖☐ᆉ❖☐ᆉ❖☐ᆉ❖❖❖║❖❖❖❖✖✖❖❖✖✖❖❖❖✖❖✖✖║                                  ║❖❖❖❖❖|▀|▀|▀|▀|▀|▀|▀|▀|▀|▀|▀|▀|▀|▀|▀|▀|▀|▀|▀|▀|▀|▀|▀|▀|▀|▀|▀|❖❖❖❖❖❖║                                ║❖❖❖❖❖❖❖❖❖❖❖❖❖❖❖❖❖❖❖❖❖║ↁ❖❖❖❖❖❖❖❖❖❖❖❖❖❖❖❖❖ꗞ║
║❖❖❖❖❖❖❖❖❖❖❖❖❖❖❖❖❖❖❖❖❖❖❖║❖❖❖❖❖❖✖✖❖❖❖❖❖❖❖✖❖║                                  ║❖❖❖❖❖❖❖❖❖❖❖❖❖❖❖❖❖❖❖❖❖❖❖❖❖❖❖❖❖❖❖❖❖❖❖❖❖❖❖❖❖❖❖❖❖❖❖❖❖❖❖❖❖❖❖❖❖❖❖❖❖❖❖❖❖❖║                                ║❖❖❖❖❖❖❖❖❖❖❖❖❖❖❖❖❖❖❖❖❖║❖❖❖❖❖❖❖❖❖❖❖❖❖❖❖❖❖❖❖║
║❖❖❖❖❖❖❖❖❖❖❖❖❖❖❖❖❖❖❖❖❖❖❖║❖❖❖❖❖❖❖✖❖❖❖❖✖❖❖❖❖║                                  ║❖❖❖❖❖|▀|▀|▀|▀|▀|▀|▀|▀|▀|▀|▀|▀|▀|▀|▀|▀|▀|▀|▀|▀|▀|▀|▀|▀|▀|▀|▀|❖❖❖❖❖❖║                                ║❖❖❖❖❖❖❖❖❖❖❖❖❖❖❖❖❖❖❖❖❖║ↁ❖❖❖❖❖❖❖❖❖❖❖❖❖❖❖❖❖ꗞ║
║❖❖❖❖❖❖❖❖❖❖❖❖❖❖❖❖❖❖❖❖❖❖❖║❖❖❖❖❖❖❖✖❖❖❖❖❖❖❖✖✖║                                  ║❖❖❖❖❖❖❖❖❖❖❖❖❖❖❖❖❖❖❖❖❖❖❖❖❖❖❖❖❖❖❖❖❖❖❖❖❖❖❖❖❖❖❖❖❖❖❖❖❖❖❖❖❖❖❖❖❖❖❖❖❖❖❖❖❖❖║                                ║❖❖❖❖❖❖❖❖❖❖❖❖❖❖❖❖❖❖❖❖❖║❖❖❖❖❖❖❖❖❖❖❖❖❖❖❖❖❖❖❖║
║❖❖❖❖❖❖❖❖❖❖❖❖❖❖❖❖❖❖❖❖✖☐☐║❖❖❖❖❖❖❖❖✖❖✖✖❖❖❖❖❖║                                  ║❖❖❖❖❖|▀|▀|▀|▀|▀|▀|▀|▀|▀|▀|▀|▀|▀|▀|▀|▀|▀|▀|▀|▀|▀|▀|▀|▀|▀|▀|▀|❖❖❖❖❖❖║                                ║❖❖❖❖❖❖❖❖❖❖❖❖❖❖❖❖❖❖❖❖❖║ↁ❖❖❖❖❖❖❖❖❖❖❖❖❖❖❖❖❖ꗞ║
╠═════════╣❖❖╠══════════╣✖✖✖✖✖✖✖✖✖✖✖✖✖❖❖❖❖║                                  ║❖❖❖❖❖❖❖❖❖❖❖❖❖❖❖❖❖❖❖❖❖❖❖❖❖❖❖❖❖❖❖❖❖❖❖❖❖❖❖❖❖❖❖❖❖❖❖❖❖❖❖❖❖❖❖❖❖❖❖❖❖❖❖❖❖❖║                                ║❖❖❖❖❖❖❖❖❖❖❖❖❖❖❖❖❖❖❖❖❖║❖❖❖❖❖❖❖❖❖❖❖❖❖❖❖❖❖❖❖║
║❖❖❖❖❖❖❖❖❖❖❖❖❖❖❖❖❖❖❖❖❖❖❖║❖❖❖❖❖❖❖❖❖❖❖❖❖❖❖❖❖║                                  ║❖❖❖❖❖|▀|▀|▀|▀|▀|▀|▀|▀|▀|▀|▀|▀|▀|▀|▀|▀|▀|▀|▀|▀|▀|▀|▀|▀|▀|▀|▀|❖❖❖❖❖❖║                                ║❖❖❖❖❖❖❖❖❖❖✖❖❖❖❖❖❖❖❖❖❖║ↁ❖❖❖❖❖❖❖❖❖❖❖❖❖❖❖❖❖ꗞ║
║❖❖❖❖❖❖❖❖❖❖❖❖❖❖❖❖❖❖❖❖❖❖❖║❖❖❖❖❖❖❖❖❖❖❖❖❖❖❖❖❖║                                  ║❖❖❖❖❖❖❖❖❖❖❖❖❖❖❖❖❖❖❖❖❖❖❖❖❖❖❖❖❖❖❖❖❖❖❖❖❖❖❖❖❖❖❖❖❖❖❖❖❖❖❖❖❖❖❖❖❖❖❖❖❖❖❖❖❖❖║                                ║❖❖❖❖❖❖❖❖❖✖❖✖❖✖❖❖❖❖❖❖❖║❖❖❖❖❖❖❖❖❖❖❖❖❖❖❖❖❖❖❖║
║❖❖❖❖❖❖❖❖❖❖❖❖❖❖❖❖❖❖❖❖❖❖❖╩❖❖❖❖❖❖❖❖❖❖❖❖❖❖❖❖❖║                                  ║❖❖❖❖❖|▀|▀|▀|▀|▀|▀|▀|▀|▀|▀|▀|▀|▀|▀|▀|▀|▀|▀|▀|▀|▀|▀|▀|▀|▀|▀|▀|❖❖❖❖❖❖║                                ║❖❖❖✖☐✖☐✖☐☐✖❖✖☐❖❖❖❖❖❖❖║ↁ❖❖❖❖❖❖❖❖❖❖❖❖❖❖❖❖❖ꗞ║
║❖❖❖❖❖❖❖❖❖❖❖❖❖❖❖❖❖❖❖❖❖❖❖❖❖❖❖❖❖❖❖❖❖❖❖❖❖❖❖❖❖║                                  ║❖❖❖❖❖❖❖❖❖❖❖❖❖❖❖❖❖❖❖❖❖❖❖❖❖❖❖❖❖❖❖❖❖❖❖❖❖❖❖❖❖❖❖❖❖❖❖❖❖❖❖❖❖❖❖❖❖❖❖❖❖❖❖❖❖❖║                                ║❖❖❖❖❖❖❖❖❖❖✖❖❖❖❖❖❖❖❖❖❖║❖❖❖❖❖❖❖❖❖❖❖❖❖❖❖❖❖❖❖║
║❖❖❖❖❖❖❖❖❖❖❖❖❖❖❖❖❖❖❖❖❖❖❖❖❖❖❖❖❖❖❖❖❖❖❖❖❖❖❖❖❖║                                  ║❖❖❖❖❖|▀|▀|▀|▀|▀|▀|▀|▀|▀|▀|▀|▀|▀|▀|▀|▀|▀|▀|▀|▀|▀|▀|▀|▀|▀|▀|▀|❖❖❖❖❖❖║                                ║❖❖❖❖❖❖❖❖❖❖❖❖❖❖❖❖❖❖❖❖❖║ↁ❖❖❖❖❖❖❖❖❖❖❖❖❖❖❖❖❖ꗞ║
║❖❖❖❖❖❖❖❖❖❖❖❖❖❖❖❖❖❖❖❖❖❖❖╦❖❖❖❖❖❖❖❖❖❖❖❖❖❖❖❖❖║                                  ║❖❖❖❖❖❖❖❖❖❖❖❖❖❖❖❖❖❖❖❖❖❖❖❖❖❖❖❖❖❖❖❖❖❖❖❖❖❖❖❖❖❖❖❖❖❖❖❖❖❖❖❖❖❖❖❖❖❖❖❖❖❖❖❖❖❖║                                ║❖❖❖❖❖❖❖❖❖❖❖❖❖❖❖❖❖❖❖❖❖║❖❖❖❖❖❖❖❖❖❖❖❖❖❖❖❖❖❖❖║
║❖❖❖❖❖❖❖❖❖❖❖❖❖❖❖❖❖❖❖❖❖❖❖║❖❖❖❖❖❖❖❖❖❖❖❖❖❖❖❖❖║                                  ║❖❖❖❖❖|▀|▀|▀|▀|▀|▀|▀|▀|▀|▀|▀|▀|▀|▀|▀|▀|▀|▀|▀|▀|▀|▀|▀|▀|▀|▀|▀|❖❖❖❖❖❖║                                ║❖❖❖❖❖❖❖❖❖❖❖❖❖❖❖❖❖❖❖❖❖║❖❖❖❖❖❖❖❖❖❖❖❖❖❖❖❖❖❖❖║
║❖❖❖❖❖❖❖❖❖❖❖❖❖❖❖❖❖❖❖❖❖❖❖║❖❖❖❖❖❖❖❖❖❖❖❖❖❖❖❖❖║                                  ║❖❖❖❖❖❖❖❖❖❖❖❖❖❖❖❖❖❖❖❖❖❖❖❖❖❖❖❖❖❖❖❖❖❖❖❖❖❖❖❖❖❖❖❖❖❖❖❖❖❖❖❖❖❖❖❖❖❖❖❖❖❖❖❖❖❖║                                ╠══════════╣❖❖╠═══════╬══╣❖❖╠═════════════╣
║❖❖❖❖❖❖❖❖❖❖❖❖❖❖❖❖❖❖❖❖❖❖❖║❖❖❖❖❖❖❖❖❖❖❖❖❖❖❖❖❖║                                  ║❖❖❖❖❖|▀|▀|▀|▀|▀|▀|▀|▀|▀|▀|▀|▀|▀|▀|▀|▀|▀|▀|▀|▀|▀|▀|▀|▀|▀|▀|▀|❖❖❖❖❖❖║                                ║❖❖❖❖❖❖❖❖❖❖❖❖❖❖❖❖❖❖❖❖❖║❖❖❖❖❖❖❖❖❖❖❖❖❖❖❖❖❖❖❖║
║❖❖❖❖❖❖❖❖❖❖❖❖❖❖❖❖❖❖❖❖❖❖❖║❖❖❖❖❖❖❖❖❖❖❖❖❖❖❖❖❖║                                  ║❖❖❖❖❖❖❖❖❖❖❖❖❖❖❖❖❖❖❖❖❖❖❖❖❖❖❖❖❖❖❖❖❖❖❖❖❖❖❖❖❖❖❖❖❖❖❖❖❖❖❖❖❖❖❖❖❖❖❖❖❖❖❖❖❖❖║                                ║❖❖❖❖❖❖❖❖❖❖❖❖❖❖❖❖❖❖❖❖❖║❖❖❖❖❖❖❖❖❖❖❖❖❖❖❖❖❖❖❖║
║❖❖❖❖❖❖❖❖❖❖❖❖❖❖❖❖❖❖❖❖❖❖❖║❖❖❖❖❖❖❖❖❖❖❖❖❖❖❖❖❖║                                  ║❖❖❖❖❖|▀|▀|▀|▀|▀|▀|▀|▀|▀|▀|▀|▀|▀|▀|▀|▀|▀|▀|▀|▀|▀|▀|▀|▀|▀|▀|▀|❖❖❖❖❖❖║                                ║❖❖❖❖❖❖❖❖❖❖❖❖❖❖❖❖❖❖❖❖❖║❖❖❖❖❖❖❖❖❖❖❖❖❖❖❖❖❖❖❖║
║❖❖❖❖❖❖❖❖❖❖❖❖❖❖❖❖❖❖❖❖❖❖❖╠═════╣❖❖╠════════╣                                  ║❖❖❖❖❖❖❖❖❖❖❖❖❖❖❖❖❖❖❖❖❖❖❖❖❖❖❖❖❖❖❖❖❖❖❖❖❖❖❖❖❖❖❖❖❖❖❖❖❖❖❖❖❖❖❖❖❖❖❖❖❖❖❖❖❖❖║                                ║❖❖❖❖❖❖❖❖❖❖❖❖❖❖❖❖❖❖❖❖❖║❖❖❖❖❖❖❖❖❖❖❖❖❖❖❖❖❖❖❖║
║❖❖❖❖❖❖❖❖❖❖❖❖❖❖❖❖❖❖❖❖❖❖❖║❖❖❖❖❖❖❖❖❖❖❖❖❖❖❖❖❖║                                  ║❖❖❖❖❖❖❖❖❖❖❖❖❖❖❖❖❖❖❖❖❖❖❖❖❖❖❖❖❖❖❖❖❖❖❖❖❖❖❖❖❖❖❖❖❖❖❖❖❖❖❖❖❖❖❖❖❖❖❖❖❖❖❖❖❖❖║                                ║❖❖❖❖❖❖❖❖❖❖❖❖❖ᆉ❖❖❖❖❖❖❖╩❖❖❖❖❖❖❖❖❖❖❖❖❖❖❖❖❖❖❖║
║❖❖❖❖❖❖❖❖❖❖❖❖❖❖❖❖❖❖❖❖❖❖❖║❖❖❖❖❖❖❖❖❖❖❖❖❖❖❖❖❖║                                  ║❖❖❖❖❖|▀|▀|▀|▀|▀|▀|▀|▀|▀|▀|▀|▀|▀|▀|▀|▀|▀|▀|▀|▀|▀|▀|▀|▀|▀|▀|▀|❖❖❖❖❖❖║                                ║❖❖❖❖❖❖❖❖❖❖❖❖❖❖❖❖❖❖❖❖❖❖❖❖❖❖❖❖❖❖❖❖❖❖❖❖❖❖❖❖❖║
║❖❖❖❖❖❖❖❖❖❖❖❖❖❖❖❖❖❖❖❖❖❖❖║❖❖❖❖❖❖❖❖❖❖❖❖❖❖❖❖❖║                                  ║❖❖❖❖❖❖❖❖❖❖❖❖❖❖❖❖❖❖❖❖❖❖❖❖❖❖❖❖❖❖❖❖❖❖❖❖❖❖❖❖❖❖❖❖❖❖❖❖❖❖❖❖❖❖❖❖❖❖❖❖❖❖❖❖❖❖║                                ║❖❖❖❖❖❖❖ᆉ❖❖❖❖❖❖❖❖❖❖❖❖❖❖❖❖❖❖❖❖❖❖❖❖❖❖❖❖❖❖❖❖❖║
║❖❖❖❖❖❖❖❖❖❖❖❖❖❖❖❖❖❖❖❖❖❖❖║❖❖❖❖❖❖❖❖❖❖❖❖❖❖❖❖❖║                                  ║❖❖❖❖❖❖❖|▀|▀|▀|▀|▀|▀|▀|▀|▀|▀|▀|▀|▀|▀|▀|▀|▀|▀|▀|▀|▀|▀|▀|▀|▀|❖❖❖❖❖❖❖❖║                                ║❖❖❖❖❖❖❖❖❖❖❖❖❖❖❖❖❖❖❖❖❖╦❖❖❖❖❖❖❖❖❖❖❖❖❖❖❖❖❖❖❖║
║❖❖❖❖❖❖❖❖❖❖❖❖❖❖❖❖❖❖❖❖❖❖❖║❖❖❖❖❖❖❖❖❖❖❖❖❖❖❖❖❖║                                  ║❖❖❖❖❖❖❖❖❖❖❖❖❖❖❖❖❖❖❖❖❖❖❖❖❖❖❖❖❖❖❖❖❖❖❖❖❖❖❖❖❖❖❖❖❖❖❖❖❖❖❖❖❖❖❖❖❖❖❖❖❖❖❖❖❖❖║                                ║❖❖❖❖❖❖❖❖❖❖❖❖❖❖❖❖❖❖❖❖❖║❖❖❖❖❖❖❖❖❖❖❖❖❖❖❖❖❖❖❖║
║❖❖❖❖❖❖❖❖❖❖❖❖❖❖❖❖❖❖❖❖❖❖❖║❖❖❖❖❖❖❖❖❖❖❖❖❖❖❖❖❖║                                  ║❖❖❖❖❖❖❖❖❖|▀|▀|▀|▀|▀|▀|▀|▀|▀|▀|▀|▀|▀|▀|▀|▀|▀|▀|▀|▀|▀|▀|▀|❖❖❖❖❖❖❖❖❖❖║                                ║❖❖❖❖❖❖❖❖❖❖❖❖❖❖❖❖❖❖❖❖❖║❖❖❖❖❖❖❖❖❖❖❖❖❖❖❖❖❖❖❖║
║❖❖❖❖❖❖❖❖❖❖❖❖❖❖❖❖❖❖❖❖❖❖❖║❖❖❖❖❖❖❖❖❖❖❖❖❖❖❖❖❖║                                  ║❖❖❖❖❖❖❖❖❖❖❖❖❖❖❖❖❖❖❖❖❖❖❖❖❖❖❖❖❖❖❖❖❖❖❖❖❖❖❖❖❖❖❖❖❖❖❖❖❖❖❖❖❖❖❖❖❖❖❖❖❖❖❖❖❖❖║                                ║❖❖❖❖❖❖❖❖❖❖❖❖❖❖❖❖❖❖❖ᆉ❖║❖❖❖❖❖❖❖❖❖❖❖❖❖❖❖❖❖❖❖║
║❖❖❖❖❖❖❖❖❖❖❖❖❖❖❖❖❖❖❖❖❖❖❖║❖❖❖❖❖❖❖❖❖❖❖❖❖❖❖❖❖║                                  ║❖❖❖❖❖❖❖❖❖❖❖|▀|▀|▀|▀|▀|▀|▀|▀|▀|▀|▀|▀|▀|▀|▀|▀|▀|▀|▀|▀|▀|❖❖❖❖❖❖❖❖❖❖❖❖║                                ║❖☐❖❖❖❖❖❖❖❖❖❖❖❖❖❖❖❖❖❖❖║❖❖❖❖❖❖❖❖❖❖❖❖❖❖❖❖❖❖❖║
╠═════════╣❖❖╠══════════╣❖❖❖❖❖❖❖❖❖❖❖❖❖❖❖❖❖║                                  ║❖❖❖❖❖❖❖❖❖❖❖❖❖❖❖❖❖❖❖❖❖❖❖❖❖❖❖❖❖❖❖❖❖❖❖❖❖❖❖❖❖❖❖❖❖❖❖❖❖❖❖❖❖❖❖❖❖❖❖❖❖❖❖❖❖❖║                                ║❖❖❖❖❖❖❖❖❖❖❖❖❖❖❖❖❖❖❖❖❖║❖❖❖❖❖❖❖❖❖❖❖❖❖❖❖❖❖❖❖║
║❖❖❖❖❖❖❖❖❖❖❖❖❖❖❖❖❖❖❖❖❖❖❖║❖❖❖❖❖❖❖❖❖❖❖❖❖❖❖❖❖║                                  ║❖❖❖❖❖❖❖❖❖❖❖❖❖|▀|▀|▀|▀|▀|▀|▀|▀|▀|▀|▀|▀|▀|▀|▀|▀|▀|▀|▀|❖❖❖❖❖❖❖❖❖❖❖❖❖❖║                                ║❖❖❖❖❖❖❖❖❖❖❖❖❖❖❖❖❖☐❖❖❖║❖❖❖❖❖❖❖❖❖❖❖❖❖❖❖❖❖❖❖║
║❖❖❖❖❖❖❖❖❖❖❖❖❖❖❖❖❖❖❖❖❖❖❖║❖❖❖❖❖❖❖❖❖❖❖❖❖❖❖❖❖║                                  ║❖❖❖❖❖❖❖❖❖❖❖❖❖❖❖❖❖❖❖❖❖❖❖❖❖❖❖❖❖❖❖❖❖❖❖❖❖❖❖❖❖❖❖❖❖❖❖❖❖❖❖❖❖❖❖❖❖❖❖❖❖❖❖❖❖❖║                                ╠══════════╣❖❖╠═══════╬══════════╣❖❖╠═════╣
║❖❖❖❖❖❖❖❖❖❖❖❖❖❖❖❖❖❖❖❖❖❖❖║❖❖❖❖❖❖❖❖❖❖❖❖❖❖❖❖❖║                                  ║❖❖❖❖❖❖❖❖❖❖❖❖❖❖❖|▀|▀|▀|▀|▀|▀|▀|▀|▀|▀|▀|▀|▀|▀|▀|▀|▀|❖❖❖❖❖❖❖❖❖❖❖❖❖❖❖❖║                                ║❖❖❖❖❖❖❖❖❖❖❖❖❖❖❖❖❖❖❖❖❖║❖❖❖❖❖❖❖❖❖❖❖❖❖❖❖❖❖❖❖║
║❖❖❖❖☐ᆉ❖❖☐ᆉ❖❖☐ᆉ❖❖☐ᆉ❖☐ᆉ❖❖║❖❖❖❖❖❖❖❖❖❖❖❖❖❖❖❖❖║                                  ║❖❖❖❖❖❖❖❖❖❖❖❖❖❖❖❖❖❖❖❖❖❖❖❖❖❖❖❖❖❖❖❖❖❖❖❖❖❖❖❖❖❖❖❖❖❖❖❖❖❖❖❖❖❖❖❖❖❖❖❖❖❖❖❖❖❖║                                ║❖❖❖❖❖❖❖❖❖❖❖❖❖❖❖❖❖❖❖❖❖║❖❖❖❖❖❖❖❖❖❖❖❖❖❖❖❖❖❖❖║
║❖❖❖❖❖❖❖❖❖❖❖❖❖❖❖❖❖❖❖❖❖❖❖║❖❖❖❖❖❖❖❖❖❖❖❖❖❖❖❖❖║                                  ║❖❖❖❖❖❖❖❖❖❖❖❖❖❖❖❖❖|▀|▀|▀|▀|▀|▀|▀|▀|▀|▀|▀|▀|▀|▀|▀|❖❖❖❖❖❖❖❖❖❖❖❖❖❖❖❖❖❖║                                ║❖❖❖❖❖❖❖❖❖❖❖❖❖❖❖❖❖❖❖❖❖║ↁ❖❖❖❖❖❖❖❖❖❖❖❖❖❖❖❖❖ꗞ║
║❖❖❖❖☐ᆉ❖❖❖❖❖❖❖❖❖❖❖❖❖❖❖❖❖║❖❖❖❖❖❖❖❖❖❖❖❖❖❖❖❖❖║                                  ║❖❖❖❖❖❖❖❖❖❖❖❖❖❖❖❖❖❖❖❖❖❖❖❖❖❖❖❖❖❖❖❖❖❖❖❖❖❖❖❖❖❖❖❖❖❖❖❖❖❖❖❖❖❖❖❖❖❖❖❖❖❖❖❖❖❖║                                ║❖❖❖❖❖❖❖❖❖❖❖❖❖❖❖❖❖❖❖❖❖║❖❖❖❖❖❖❖❖❖❖❖❖❖❖❖❖❖❖❖║
║❖❖❖❖❖❖❖❖❖❖❖❖❖❖❖❖❖❖❖❖❖❖❖║❖❖❖❖❖❖❖❖❖❖❖❖❖❖❖❖❖║                                  ║❖❖❖❖❖❖❖❖❖❖❖❖❖❖❖❖❖❖❖❖|▀|▀|▀|▀|▀|▀|▀|▀|▀|▀|▀|▀|❖❖❖❖❖❖❖❖❖❖❖❖❖❖❖❖❖❖❖❖❖║                                ║❖❖❖❖❖❖❖❖❖❖❖❖❖❖❖❖❖✖✖✖✖║❖❖❖❖❖❖❖❖❖❖❖❖❖❖❖❖❖❖ꗞ║
║❖❖❖❖❖❖❖❖❖❖❖❖❖❖❖❖❖❖❖☐ᆉ❖❖╠═════╣❖❖╠════════╣                                  ║❖❖❖❖❖❖❖❖❖❖❖❖❖❖❖❖❖❖❖❖❖❖❖❖❖❖❖❖❖❖❖❖❖❖❖❖❖❖❖❖❖❖❖❖❖❖❖❖❖❖❖❖❖❖❖❖❖❖❖❖❖❖❖❖❖❖║                                ║❖❖❖❖❖❖❖❖❖❖❖❖❖❖❖❖✖❖❖❖❖║ↁ❖❖❖❖❖❖❖❖❖❖❖❖❖❖❖❖❖❖║
║❖❖❖❖❖☐ᆉ❖❖❖❖❖❖❖❖❖❖❖❖❖❖❖❖║❖❖❖❖❖❖❖❖❖❖❖❖❖❖❖❖❖║                                  ║❖❖❖❖❖❖❖❖❖❖❖❖❖❖❖❖❖❖❖❖❖❖|▀|▀|▀|▀|▀|▀|▀|▀|▀|▀|❖❖❖❖❖❖❖❖❖❖❖❖❖❖❖❖❖❖❖❖❖❖❖║                                ║❖❖❖❖❖❖❖❖❖❖❖❖❖❖❖❖✖❖❖❖ᆉ║❖❖❖❖❖❖❖❖❖❖❖❖❖❖❖❖❖❖ꗞ║
║❖❖❖❖❖❖❖❖❖❖❖❖❖❖❖❖❖❖❖❖❖❖❖║❖❖❖❖❖❖❖❖❖❖❖❖❖❖❖❖❖║                                  ║❖❖❖❖❖❖❖❖❖❖❖❖❖❖❖❖❖❖❖❖❖❖❖❖❖❖❖❖❖❖❖❖❖❖❖❖❖❖❖❖❖❖❖❖❖❖❖❖❖❖❖❖❖❖❖❖❖❖❖❖❖❖❖❖❖❖║                                ║❖❖❖❖❖❖❖❖❖❖❖❖❖❖❖❖✖❖❖ᆉ❖║❖❖❖❖❖❖❖❖❖❖❖❖❖❖❖❖❖❖❖║
║ↁ❖❖❖❖❖☐ᆉ❖❖❖❖❖❖❖❖❖❖❖☐ᆉ❖❖║❖❖❖❖❖❖❖❖❖❖❖❖❖❖❖❖❖║                                  ║❖❖❖❖❖❖❖❖❖❖❖❖❖❖❖❖❖❖❖❖❖❖❖❖|▀|▀|▀|▀|▀|▀|▀|▀|❖❖❖❖❖❖❖❖❖❖❖❖❖❖❖❖❖❖❖❖❖❖❖❖❖║                                ║❖❖☐❖❖❖❖❖❖❖❖❖❖❖❖❖❖❖❖ᆉ❖║ↁ❖❖❖❖❖❖❖❖❖❖❖❖❖❖❖❖❖ꗞ║
║❖❖❖❖❖❖❖❖❖❖❖❖❖❖❖❖❖❖❖❖❖❖❖║❖❖❖❖❖❖❖❖❖❖❖❖❖❖❖❖❖║                                  ║❖❖❖❖❖❖❖❖❖❖❖❖❖❖❖❖❖❖❖❖❖❖❖❖❖❖❖❖❖❖❖❖❖❖❖❖❖❖❖❖❖❖❖❖❖❖❖❖❖❖❖❖❖❖❖❖❖❖❖❖❖❖❖❖❖❖║                                ║❖❖❖❖ᆉ❖❖❖❖❖❖❖❖❖❖❖✖❖❖❖❖║❖❖❖❖❖❖❖❖❖❖❖❖❖❖❖❖❖❖❖║
║❖❖❖❖❖❖❖❖❖❖❖❖❖❖❖❖❖❖❖❖❖❖❖║❖❖❖❖❖❖❖❖❖❖❖❖❖❖❖❖❖║                                  ║❖❖❖❖❖❖❖❖❖❖❖❖❖❖❖❖❖❖❖❖❖❖❖❖❖❖❖❖❖❖❖❖❖❖❖❖❖❖❖❖❖❖❖❖❖❖❖❖❖❖❖❖❖❖❖❖❖❖❖❖❖❖❖❖❖❖║                                ║❖❖❖❖❖❖❖❖❖❖❖❖❖❖❖❖❖✖❖❖ᆉ║❖❖❖❖❖❖❖❖❖❖❖❖❖❖❖❖❖❖ꗞ║
║❖❖❖❖❖❖❖❖❖❖❖❖❖❖☐ᆉ❖❖❖☐ᆉ❖❖║❖❖❖❖❖❖❖❖❖❖❖❖❖❖❖❖❖║                                  ║❖❖❖❖❖❖❖❖❖❖❖❖❖❖❖❖❖❖❖❖❖❖❖❖❖❖❖❖❖❖❖❖❖❖❖❖❖❖❖❖❖❖❖❖❖❖❖❖❖❖❖❖❖❖❖❖❖❖❖❖❖❖❖❖❖❖║                                ║❖❖❖❖❖❖❖❖❖❖❖❖❖❖❖❖❖❖✖❖❖║ↁ❖❖❖❖❖❖❖❖❖❖❖❖❖❖❖❖❖❖║
║❖❖❖❖❖❖☐ᆉ❖❖❖❖❖❖❖❖❖❖❖❖❖❖❖║❖❖❖❖❖❖❖❖❖❖❖❖❖❖❖❖❖║                                  ║❖❖❖❖❖❖❖❖❖❖❖❖❖❖❖❖❖❖❖❖❖❖❖❖❖❖❖❖❖❖❖❖❖❖❖❖❖❖❖❖❖❖❖❖❖❖❖❖❖❖❖❖❖❖❖❖❖❖❖❖❖❖❖❖❖❖║                                ║❖❖❖❖❖❖❖❖❖❖❖❖❖❖❖❖❖❖❖✖❖║❖❖❖❖❖❖❖❖❖❖❖❖❖❖❖❖❖❖ꗞ║
║❖❖❖❖❖❖❖❖❖❖☐ᆉ❖❖❖❖❖❖❖❖❖❖❖║❖❖❖❖❖❖❖❖❖❖❖❖❖❖❖❖❖║                                  ║❖❖❖❖❖❖❖❖❖❖❖❖❖❖❖❖❖❖❖❖❖❖❖❖❖❖❖❖❖❖❖❖❖❖❖❖❖❖❖❖❖❖❖❖❖❖❖❖❖❖❖❖❖❖❖❖❖❖❖❖❖❖❖❖❖❖║                                ║❖❖❖❖❖❖❖❖❖❖❖❖❖❖❖❖❖❖❖❖✖║❖❖❖❖❖❖❖❖❖❖❖❖❖❖❖❖❖❖❖║
║❖❖❖❖❖❖❖❖❖❖❖❖❖❖❖❖❖❖❖❖❖❖❖║❖❖❖❖❖❖❖❖❖❖❖❖❖❖❖❖❖║                                  ║❖❖❖❖❖❖❖❖❖❖❖❖❖❖❖❖❖❖❖❖❖❖❖❖❖❖❖❖❖❖❖❖❖❖❖❖❖❖❖❖❖❖❖❖❖❖❖❖❖❖❖❖❖❖❖❖❖❖❖❖❖❖❖❖❖❖║                                ║❖❖❖❖❖❖❖❖❖❖❖❖❖❖❖❖❖❖❖❖❖║ↁ❖❖❖❖❖❖❖❖❖❖❖❖❖❖❖❖❖❖║
╠═══════════════════════╩═════╣❖❖╠════════╩═══════════════════════════════╦══╩══════════════════════════════╦══════════════════════╣❖❖╠═════════╩═══════════════╦════════════════╩══════════╣❖❖╠═══════╩═══════════════════╣
║❖☐☐☐☐☐☐☐☐☐☐☐☐☐☐☐☐☐❖❖❖❖❖❖❖❖❖❖❖❖❖❖❖❖❖❖❖❖❖❖❖❖❖❖❖❖❖❖❖❖❖❖❖❖❖❖❖❖❖❖❖❖❖❖❖❖❖❖❖❖❖❖❖║❖❖❖❖❖❖❖❖❖❖❖❖❖❖❖❖❖❖❖❖❖❖❖❖❖❖❖❖❖❖❖❖❖║❖❖❖❖❖❖❖❖❖❖❖❖❖❖❖❖❖❖❖❖❖❖❖❖❖❖❖❖❖❖❖❖❖❖❖❖❖❖❖❖❖❖❖❖❖❖❖❖❖❖❖║❖❖❖❖❖❖❖❖❖❖❖❖❖❖❖❖❖❖❖❖❖❖❖❖❖❖❖❖❖❖❖❖❖❖❖❖❖❖❖❖❖❖❖❖❖❖❖❖❖❖❖❖❖❖❖❖❖❖║
║❖❖❖❖❖❖❖❖❖❖❖❖❖❖❖❖❖❖❖❖❖❖❖❖❖❖❖❖❖❖❖❖❖❖❖❖❖❖❖❖❖❖❖❖❖❖❖❖❖❖❖❖❖❖❖❖❖❖❖❖❖❖❖❖❖❖❖❖❖❖❖❖❖║❖❖❖❖❖❖❖❖❖❖❖❖❖❖❖❖❖❖❖❖❖❖❖❖❖❖❖❖❖❖❖❖❖║❖❖❖❖❖❖❖❖❖❖❖❖❖❖❖❖❖❖❖❖❖❖❖❖❖❖❖❖✖❖❖❖❖❖❖❖❖❖❖❖❖❖❖❖❖❖❖❖❖❖❖║❖❖❖❖❖❖❖❖❖❖❖❖❖❖❖❖❖❖❖❖❖❖❖❖❖❖❖❖❖❖❖❖❖❖❖❖❖❖❖❖❖❖❖❖❖❖❖❖❖❖❖❖❖❖❖❖❖❖║
║❖❖❖❖❖❖❖❖❖❖❖❖❖❖❖❖❖❖❖❖❖❖❖❖❖❖❖❖❖❖❖❖❖❖❖❖❖❖❖❖❖❖❖❖❖❖❖❖❖❖❖❖❖❖❖❖❖❖❖❖❖❖❖❖❖❖❖❖❖❖❖❖❖╩❖❖❖❖❖❖❖❖❖❖❖❖❖❖❖❖❖❖❖❖❖❖❖❖❖❖❖❖❖❖❖❖❖║❖❖❖❖❖❖❖❖❖❖❖❖❖❖❖❖❖❖❖❖❖❖❖❖❖❖❖✖✖✖❖❖❖❖❖❖❖❖❖❖❖❖❖❖❖❖❖❖❖❖❖║❖❖❖❖❖❖❖❖❖❖❖❖❖❖❖❖❖❖❖❖❖❖❖❖❖❖❖❖❖❖❖❖❖❖❖❖❖❖❖❖❖❖❖❖❖❖❖❖❖❖❖❖❖❖❖❖❖❖║
║❖❖❖❖❖❖❖❖❖❖❖❖❖❖❖❖❖❖❖❖❖❖❖❖❖❖❖❖❖❖❖❖❖❖❖❖❖❖❖❖❖❖❖❖❖❖❖❖❖❖❖❖❖❖❖❖❖❖❖❖❖❖❖❖❖❖❖❖❖❖❖❖❖❖❖❖❖❖❖❖❖❖❖❖❖❖❖❖❖❖❖❖❖❖❖❖❖❖❖❖❖❖❖❖❖❖❖║❖❖❖❖❖❖❖❖❖❖❖❖❖❖❖❖❖❖❖❖❖❖❖❖❖❖✖✖✖✖❖❖❖❖❖❖❖❖❖❖❖❖❖❖❖❖❖❖❖❖❖║❖❖❖❖❖❖❖❖❖❖❖❖❖❖❖❖❖❖❖❖❖❖❖❖❖❖❖❖❖❖❖❖❖❖❖❖❖❖❖❖❖❖❖❖❖❖❖❖❖❖❖❖❖❖❖❖❖❖║
║❖❖❖❖❖❖❖❖❖❖❖❖❖❖❖❖❖❖❖❖❖❖❖❖❖❖❖❖❖❖❖❖❖❖❖❖❖❖❖❖❖❖❖❖❖❖❖❖❖❖❖❖❖❖❖❖❖❖❖❖❖❖❖❖❖❖❖❖❖❖❖❖❖❖❖❖❖❖❖❖❖❖❖❖❖❖❖❖❖❖❖❖❖❖❖❖❖❖❖❖❖❖❖❖❖❖❖║❖❖❖❖❖❖❖❖❖❖❖❖❖❖❖❖❖❖❖❖❖❖❖❖❖✖✖✖✖✖❖❖❖❖❖❖❖❖❖❖❖❖❖❖❖❖❖❖❖❖❖╩❖❖❖❖❖❖❖❖❖❖❖❖❖❖❖❖❖❖❖❖❖❖❖❖❖❖❖❖❖❖❖❖❖❖❖❖❖❖❖❖❖❖❖❖❖❖❖❖❖❖❖❖❖❖❖❖❖❖║
║❖❖❖❖❖❖❖❖❖❖❖❖❖❖❖❖❖❖❖❖❖❖❖❖❖❖❖❖❖❖❖❖❖❖❖❖❖❖❖❖❖❖❖✖❖❖❖❖❖❖❖❖❖❖❖❖❖❖❖❖❖❖❖❖❖❖❖❖❖❖❖❖❖╦❖❖❖❖❖❖❖❖❖❖❖❖❖❖❖❖❖❖❖❖❖❖❖❖❖❖❖❖❖❖❖❖❖║❖❖❖❖❖❖❖❖❖❖❖❖❖❖❖❖❖❖❖❖❖❖❖❖❖❖✖✖✖❖❖❖❖❖❖❖❖❖❖❖❖❖❖❖❖❖❖❖❖❖❖❖❖❖❖❖❖❖❖❖❖❖❖❖❖❖❖❖❖❖❖❖❖❖❖❖❖❖❖❖❖❖❖❖❖❖❖❖❖❖❖❖❖❖❖❖❖❖❖❖❖❖❖❖❖❖❖❖❖❖║
║❖❖❖❖❖❖❖❖❖❖❖❖❖❖❖❖❖❖❖❖❖❖❖❖❖❖❖❖❖❖❖❖❖❖❖❖❖❖❖❖❖✖❖❖❖❖❖❖❖❖❖❖❖❖❖❖❖❖❖❖❖❖❖❖❖❖❖❖❖❖❖❖❖║❖❖❖❖❖❖❖❖❖❖❖❖❖❖❖❖❖❖❖❖❖❖❖❖❖❖❖❖❖❖❖❖❖║❖❖❖❖❖❖❖❖❖❖❖❖❖❖❖❖❖❖❖❖❖❖❖❖❖❖❖✖❖❖❖❖❖❖❖❖❖❖❖❖❖❖❖❖❖❖❖❖❖❖❖❖❖❖❖❖❖❖❖❖❖❖❖❖❖❖❖❖❖❖❖❖❖❖❖❖❖❖❖❖❖❖❖❖❖❖❖❖❖❖❖❖❖❖❖❖❖❖❖❖❖❖❖❖❖❖❖❖❖❖║
║❖❖❖❖❖❖❖❖❖❖❖❖❖❖❖❖❖❖❖❖❖❖❖❖❖❖❖❖❖❖❖❖❖❖❖❖❖❖❖✖❖❖❖❖❖❖❖❖❖❖❖❖❖❖❖❖❖❖❖❖❖❖❖❖❖❖❖❖❖❖❖❖❖║❖❖❖☐❖❖❖❖❖❖❖❖❖❖❖❖❖❖❖❖❖❖❖❖❖❖❖❖❖❖❖❖❖║❖❖❖❖❖❖❖❖❖❖❖❖❖❖❖❖❖❖❖❖❖❖❖❖❖❖❖❖❖❖❖❖❖❖❖❖❖❖❖❖❖❖❖❖❖❖❖❖❖❖❖╦❖❖❖❖❖❖❖❖❖❖❖❖❖❖❖❖❖❖❖❖❖❖❖❖❖❖❖❖❖❖❖❖❖❖❖❖❖❖❖❖❖❖❖❖❖❖❖❖❖❖❖❖❖❖❖❖❖❖║
║❖❖❖❖❖❖❖❖❖❖❖❖❖❖❖❖❖❖❖❖❖❖❖❖❖❖❖❖❖❖❖❖❖❖❖❖❖❖✖❖❖❖❖❖❖❖❖❖❖❖❖❖❖❖❖❖❖❖❖❖❖❖❖❖❖❖❖❖❖❖❖❖❖║❖❖❖❖❖ᆉ❖❖❖❖❖❖❖❖❖❖❖❖❖❖❖❖❖❖❖❖❖❖❖❖❖❖❖║❖❖❖❖❖❖❖❖❖❖❖❖❖❖❖❖❖❖❖❖❖❖❖❖❖❖❖❖❖❖❖❖❖❖❖❖❖❖❖❖❖❖❖❖❖❖❖❖❖❖❖║❖❖❖❖❖❖❖❖❖❖❖❖❖❖❖❖❖❖❖❖❖❖❖❖❖❖❖❖❖❖❖❖❖❖❖❖❖❖❖❖❖❖❖❖❖❖❖❖❖❖❖❖❖❖❖❖❖❖║
║❖❖❖❖❖❖❖❖❖❖❖❖❖❖❖❖❖❖❖❖❖❖❖❖❖❖❖❖❖❖❖❖❖❖❖❖❖✖✖✖❖❖❖❖❖❖❖❖❖❖❖❖❖❖❖❖❖❖❖❖❖❖❖❖❖❖❖❖❖❖❖❖❖║❖❖❖❖❖❖ᆉ❖❖☐❖❖❖❖❖❖❖❖❖❖❖❖❖❖❖❖❖❖❖❖❖❖❖╩❖❖❖❖❖❖❖❖❖❖❖❖❖❖❖❖❖❖❖❖❖❖❖❖❖❖❖❖❖❖❖❖❖❖❖❖❖❖❖❖❖❖❖❖❖❖❖❖❖❖❖║❖❖❖❖❖❖❖❖❖❖❖❖❖❖❖❖❖❖❖❖❖❖❖❖❖❖❖❖❖❖❖❖❖❖❖❖❖❖❖❖❖❖❖❖❖❖❖❖❖❖❖❖❖❖❖❖❖❖║
║❖❖❖❖❖❖❖❖❖❖❖❖❖❖❖❖❖❖❖❖❖❖❖❖❖❖❖❖❖❖❖❖❖❖❖❖✖✖✖✖❖❖❖❖❖❖❖❖❖❖❖❖❖❖❖❖❖❖❖❖❖❖❖❖❖❖❖❖❖❖❖❖❖║❖❖☐❖❖☐❖ᆉ❖❖❖❖❖❖❖❖❖❖❖❖❖❖❖❖❖❖❖❖❖❖❖❖❖❖❖❖❖❖❖❖❖❖❖❖❖❖❖❖❖❖❖❖❖❖❖❖❖❖❖❖❖❖❖❖❖❖❖❖❖❖❖❖❖❖❖❖❖❖❖❖❖❖❖❖❖║❖❖❖❖❖❖❖❖❖❖❖❖❖❖❖❖❖❖❖❖❖❖❖❖❖❖❖❖❖❖❖❖❖❖❖❖❖❖❖❖❖❖❖❖❖❖❖❖❖❖❖❖❖❖❖❖❖❖║
║❖❖❖❖❖❖❖❖❖❖❖❖❖❖❖❖❖❖❖❖❖❖❖❖❖❖❖❖❖❖❖❖❖❖❖✖☐☐✖✖❖❖❖❖❖❖❖❖❖❖❖❖❖❖❖❖❖❖❖❖❖❖❖❖❖❖❖❖❖❖❖❖❖║❖❖❖❖❖❖❖❖ᆉ❖❖❖❖❖❖❖❖❖❖❖❖❖❖❖❖❖❖❖❖❖❖❖❖❖❖❖❖❖❖❖❖❖❖❖❖❖❖❖❖❖❖❖❖❖❖❖❖❖❖❖❖❖❖❖❖❖❖❖❖❖❖❖❖❖❖❖❖❖❖❖❖❖❖❖❖║❖❖❖❖❖❖❖❖❖❖❖❖❖❖❖❖❖❖❖❖❖❖❖❖❖❖❖❖❖❖❖❖❖❖❖❖❖❖❖❖❖❖❖❖❖❖❖❖❖❖❖❖❖❖❖❖❖❖║
║❖☐☐☐☐☐☐☐☐✉✉☐☐☐☐❖❖❖❖❖❖❖❖❖❖❖❖❖❖❖❖❖❖❖✖✖✖✖✖✖✖❖❖❖❖❖❖❖❖❖❖❖❖❖❖❖❖❖❖❖❖❖❖❖❖❖❖❖❖❖❖❖❖║❖❖❖☐❖❖ᆉ❖❖❖❖❖❖❖❖❖❖❖❖❖❖❖❖❖❖❖❖❖❖❖❖❖❖╦❖❖❖❖❖❖❖❖❖❖❖❖❖❖❖❖❖❖❖❖❖❖❖❖❖❖❖❖❖❖❖❖❖❖☐ᆉ☐ᆉ☐ᆉ☐ᆉ☐ᆉ☐✉☐ᆉ☐☐☐║❖❖❖❖❖❖❖❖❖❖❖❖❖❖❖❖❖❖❖❖❖❖❖❖❖❖❖❖❖❖❖❖❖❖❖❖❖❖❖❖❖❖❖❖❖❖❖❖❖❖❖❖❖❖❖❖❖❖║
╠═══════════╦════════╣❖❖╠══════════════════════╦══════════════════════════╬════════════════╣❖❖╠═════════════╬══════════════╣❖❖╠══════════╦══════════════════════╩════════════════╦══════════════╣❖❖╠═══════════════════════╣
║❖❖❖❖❖❖❖❖❖❖❖╩❖❖❖❖❖❖❖❖❖❖❖❖❖❖❖❖❖❖❖❖❖❖❖❖❖❖❖❖❖❖❖❖❖❖║❖❖❖❖❖❖❖❖❖❖❖❖❖❖❖❖❖❖❖❖❖❖❖❖❖❖║❖❖❖❖❖❖❖❖❖❖❖❖❖❖❖❖❖❖❖❖❖❖❖❖❖❖❖❖❖❖❖❖❖║❖❖❖❖❖❖❖❖❖❖❖❖❖❖❖❖❖❖❖❖❖❖❖❖❖❖❖❖║❖❖❖❖❖❖❖❖❖❖❖❖❖❖❖❖❖❖❖❖❖❖❖❖❖❖❖❖❖❖❖❖❖❖❖❖❖❖❖║❖❖❖❖❖❖❖❖❖❖❖❖❖❖❖❖❖❖❖❖❖❖✖❖❖❖❖❖❖❖❖❖❖❖❖❖❖❖❖❖❖║
║❖❖❖❖❖❖❖❖❖❖❖❖❖❖❖❖❖❖❖❖❖❖❖❖❖❖❖❖❖❖❖❖❖❖❖❖❖❖❖❖❖❖❖❖❖❖║❖❖❖❖❖❖❖❖❖❖❖❖❖❖❖❖❖❖❖❖❖❖❖❖❖❖║❖❖❖❖❖❖❖❖❖❖❖❖❖❖❖❖❖❖❖❖❖❖❖❖❖❖❖❖❖❖❖❖❖║❖❖❖❖❖❖❖❖❖❖❖❖❖❖❖❖❖❖❖❖❖❖❖❖❖❖❖❖║ↁ❖❖❖❖❖❖❖❖❖❖❖❖❖❖❖❖❖❖❖❖❖❖❖❖❖❖❖❖❖❖❖❖❖❖❖❖❖❖║❖❖❖❖❖❖❖❖❖❖❖❖❖❖❖❖❖❖❖❖✖☐❖❖❖❖❖❖❖❖❖❖❖❖❖❖❖❖❖❖❖║
║❖❖❖❖❖❖❖❖❖❖❖❖❖❖❖❖❖❖❖❖❖❖❖❖❖❖❖❖❖❖❖❖❖❖❖❖❖❖❖❖❖❖❖❖❖❖║❖❖❖❖❖❖❖❖❖❖❖❖❖❖❖❖❖❖❖❖❖❖❖❖❖❖║❖❖❖❖❖❖❖❖❖❖❖❖❖❖❖❖❖❖❖❖❖❖❖❖❖❖❖❖3❖❖❖❖║❖❖❖❖❖❖❖❖❖❖❖❖❖❖❖❖❖❖❖❖❖❖❖❖❖❖❖❖║❖❖❖❖❖☐ᆉ❖❖☐ᆉ❖❖☐ᆉ❖❖☐ᆉ❖❖☐ᆉ❖❖☐ᆉ❖❖☐ᆉ❖❖☐ᆉ❖❖❖❖║❖❖❖❖❖❖❖❖❖❖❖❖❖❖❖❖❖❖✖❖❖❖❖❖❖❖❖❖❖❖❖❖❖❖❖❖❖❖❖❖❖║
║❖❖❖❖❖❖❖❖❖❖❖╦❖❖❖❖❖❖❖❖❖❖❖❖❖❖❖❖❖❖❖❖❖❖❖❖❖❖❖❖❖❖❖❖❖❖║❖❖❖❖❖❖❖✖✖✖✖✖✖✖✖✖✖✖✖✖✖✖✖❖❖❖║❖❖❖❖❖❖❖❖❖❖❖❖❖❖❖❖❖❖❖❖❖❖❖❖❖❖❖❖❖❖❖❖❖║❖❖❖❖❖❖❖❖❖❖❖❖❖❖❖❖❖❖❖❖❖❖❖❖❖❖❖❖║❖❖❖❖❖❖❖❖❖❖❖❖❖❖❖❖❖❖❖❖❖❖❖❖❖❖❖❖❖❖❖❖❖❖❖❖❖❖❖║❖❖❖❖❖❖❖❖❖✖✖❖☐✖❖✖❖❖❖❖❖❖❖❖❖❖❖❖❖❖❖❖❖❖❖❖❖❖❖❖❖║
║❖❖❖❖❖❖❖❖❖❖❖║❖❖❖❖❖❖❖❖❖❖❖❖❖❖❖❖❖❖❖❖❖❖❖❖❖❖❖❖❖❖❖❖❖❖║❖❖❖❖❖❖❖❖❖❖❖❖✖✖✖✖✖✖✖✖✖✖✖✖✖❖║❖❖1❖❖❖❖❖❖❖❖❖❖❖❖❖❖❖❖❖❖❖❖❖❖❖❖❖❖❖❖❖❖║❖❖❖❖❖❖❖❖❖❖❖❖❖❖❖❖❖❖❖❖❖❖❖❖❖❖❖❖║❖❖❖❖❖☐ᆉ❖❖☐ᆉ❖❖☐ᆉ❖❖☐ᆉ❖❖☐ᆉ❖❖☐ᆉ❖❖☐ᆉ❖❖☐ᆉ❖❖❖❖║❖❖❖❖❖❖❖❖❖❖❖❖❖❖❖❖❖❖❖❖❖❖❖❖❖❖❖❖❖❖❖❖❖❖❖❖❖❖❖❖☐║
║❖❖❖❖❖❖❖❖❖❖☐║❖❖❖❖❖❖❖❖❖❖❖❖❖❖❖❖❖❖❖❖❖❖❖❖❖❖❖❖❖❖❖❖❖❖║❖❖❖❖❖❖❖❖❖❖❖❖❖❖❖❖❖❖❖❖❖❖❖❖❖❖║❖❖❖❖❖❖❖❖❖❖❖❖❖❖❖❖❖❖❖❖❖❖❖❖❖❖❖❖❖❖❖❖❖║❖❖❖❖❖❖❖❖❖❖❖❖❖❖❖❖❖❖❖❖❖❖❖❖❖❖❖❖║❖❖❖❖❖❖❖❖❖❖❖❖❖❖❖❖❖❖❖❖❖❖❖❖❖❖❖❖❖❖❖❖❖❖❖❖❖❖❖║❖❖❖❖❖❖❖❖❖❖❖❖❖❖❖❖❖❖❖❖❖❖❖❖❖❖❖❖❖❖❖❖❖❖❖❖❖❖❖❖☐║
║❖❖❖❖❖❖❖❖❖❖☐║❖❖❖❖❖❖❖❖❖❖❖❖❖❖❖❖❖❖❖❖❖❖❖❖❖❖❖❖❖❖❖❖❖❖║❖❖❖❖❖❖❖❖❖❖❖❖❖❖❖❖❖❖❖❖❖❖❖❖❖❖║❖❖❖❖❖❖❖❖❖❖❖❖❖❖❖❖❖❖❖❖❖❖❖❖❖❖❖❖❖❖❖❖❖║❖❖❖❖❖❖❖❖❖❖❖❖❖❖❖❖❖❖❖❖❖❖❖❖❖❖❖❖║❖❖❖❖❖☐ᆉ❖❖☐ᆉ❖❖☐ᆉ❖❖☐ᆉ❖❖☐ᆉ❖❖☐ᆉ❖❖☐ᆉ❖❖☐ᆉ❖❖❖❖║❖❖❖❖❖❖❖❖❖❖✖❖❖❖❖✖❖❖❖❖❖❖❖❖❖❖❖❖❖❖❖❖❖❖❖❖❖❖❖❖☐║
║❖❖❖❖❖❖❖❖❖❖✉║❖❖❖❖❖❖❖❖❖❖❖❖❖❖❖❖❖❖❖❖❖❖❖❖❖❖❖❖❖❖❖❖❖❖╩❖❖❖❖❖❖❖❖❖❖❖❖❖❖❖❖❖❖❖❖❖❖❖❖❖❖║❖❖❖❖❖❖❖❖❖❖❖❖❖❖❖❖❖❖❖❖❖❖❖❖❖❖❖❖❖❖❖❖❖║❖❖❖❖❖❖❖❖❖❖❖❖❖❖❖❖❖❖❖❖❖❖❖❖❖❖❖❖║❖❖❖❖❖❖❖❖❖❖❖❖❖❖❖❖❖❖❖❖❖❖❖❖❖❖❖❖❖❖❖❖❖❖❖❖❖❖❖║❖❖❖❖❖❖❖❖❖❖❖❖❖✖❖❖❖✖❖❖❖❖❖❖❖❖❖❖❖❖❖❖❖❖❖❖❖❖❖❖☐║
║❖❖❖❖❖❖❖❖❖❖☐║❖❖❖❖❖❖❖❖❖❖❖❖❖❖❖❖❖❖❖❖❖❖❖❖❖❖❖❖❖❖❖❖❖❖❖❖❖❖❖❖❖❖❖❖❖❖❖❖❖❖❖❖❖❖❖❖❖❖❖❖❖║❖❖❖❖❖❖❖❖❖❖❖❖❖❖❖❖❖❖❖❖❖❖❖❖❖❖❖❖❖❖❖❖❖║❖❖❖❖❖❖❖❖❖❖❖❖❖❖❖❖❖❖❖❖❖❖❖❖❖❖❖❖║❖❖❖❖❖☐ᆉ❖❖☐ᆉ❖❖☐ᆉ❖❖☐ᆉ❖❖☐ᆉ❖❖☐ᆉ❖❖❖❖❖❖☐ᆉ❖❖❖❖║❖❖❖❖❖❖❖❖❖❖❖❖☐❖❖❖❖❖❖❖❖❖❖❖❖❖❖❖❖❖❖❖❖❖❖❖❖❖❖❖✉║
║❖❖❖❖❖❖❖❖❖❖❖║❖❖❖❖❖❖❖❖❖❖❖❖❖❖❖❖❖❖❖❖❖❖❖❖❖❖❖❖❖❖❖❖❖❖❖❖❖❖❖❖❖❖❖❖❖❖❖❖❖❖❖❖❖❖❖❖❖❖❖❖❖║❖❖❖❖❖❖❖❖❖❖❖❖❖❖❖❖❖❖❖❖❖❖❖❖❖❖❖❖❖❖❖❖❖║❖❖❖❖❖❖❖❖❖❖❖❖❖❖❖❖❖❖❖❖❖❖❖❖❖❖❖❖║❖❖❖❖❖❖❖❖❖❖❖❖❖❖❖❖❖❖❖❖❖❖❖❖❖❖❖❖❖☐ᆉ❖❖❖❖❖❖❖❖║❖❖❖❖❖❖❖❖❖❖❖❖❖✖❖❖❖❖❖❖❖❖❖❖❖❖❖❖❖❖✖❖❖❖❖❖❖❖❖❖☐║
║❖❖❖❖❖❖❖❖❖❖☐║❖❖❖❖❖❖❖❖❖❖❖❖❖❖❖❖❖❖❖❖❖❖❖❖❖❖❖❖❖❖❖❖❖❖╦❖❖☐ᆉ☐☐☐☐☐❖❖❖☐❖❖❖☐❖☐☐☐☐☐☐ᆉ❖║❖❖❖❖❖❖❖❖❖❖❖❖❖❖❖❖❖❖❖❖❖❖❖❖❖❖❖❖❖❖❖❖❖║❖❖❖❖❖❖❖❖❖❖❖❖❖❖❖❖❖❖❖❖❖❖❖❖❖❖❖❖║❖❖❖❖❖☐ᆉ❖❖☐ᆉ❖❖❖❖❖❖☐ᆉ❖❖☐ᆉ❖❖☐ᆉ❖❖☐ᆉ❖❖☐ᆉ❖❖❖❖║❖❖❖❖❖❖❖❖❖❖❖❖❖❖❖❖❖❖❖❖❖❖❖❖❖❖❖❖❖❖❖❖❖❖❖❖❖❖❖❖✉║
║❖❖❖❖❖❖❖❖❖❖☐║❖❖❖❖❖❖❖❖❖❖❖❖❖❖❖❖❖❖❖❖❖❖❖❖❖❖❖❖❖❖❖❖❖❖║❖☐❖❖❖❖❖❖❖❖❖❖❖☐☐☐❖❖☐❖☐☐☐ᆉ❖❖║❖❖❖❖❖❖❖❖❖❖❖❖❖❖❖❖❖❖❖❖❖❖❖❖❖❖❖❖❖❖2❖❖║❖❖❖❖❖❖❖❖❖❖❖❖❖❖❖❖❖❖❖❖❖❖❖❖❖❖❖❖║❖❖❖❖❖❖❖❖❖❖❖❖❖❖❖❖❖❖❖❖❖❖❖❖❖❖❖❖❖❖❖❖❖❖❖❖❖❖❖║❖❖❖❖❖❖❖❖❖❖❖❖❖❖❖❖❖❖❖❖❖❖❖❖❖❖❖❖❖❖❖❖❖❖❖❖❖❖❖❖☐║
║❖❖❖❖❖❖❖❖❖❖☐║ↁ❖❖❖❖❖❖❖❖❖❖❖❖❖❖❖❖❖❖❖❖❖❖❖❖❖❖❖❖❖❖❖❖❖║❖❖☐ᆉ❖☐❖❖❖❖❖❖❖❖ᆉ❖❖❖❖❖❖❖❖❖❖❖║❖❖❖❖❖❖❖❖❖❖❖❖❖❖❖❖❖❖❖❖❖❖❖❖❖❖❖❖❖❖❖❖❖║ↁ❖❖❖❖❖❖❖❖❖❖❖❖❖❖❖❖❖❖❖❖❖❖❖❖❖❖❖╩❖❖❖❖❖❖❖❖❖❖❖❖❖❖❖❖❖❖❖❖❖❖❖❖❖❖❖❖❖❖❖❖❖❖❖❖❖❖❖║❖❖❖❖❖❖❖❖❖❖❖❖❖❖❖❖❖❖❖❖❖❖❖❖❖❖❖❖❖❖✖❖❖❖❖❖❖❖❖❖☐║
║❖❖❖❖❖❖❖❖❖❖☐║❖❖❖❖❖❖❖❖❖❖❖❖❖❖❖❖❖❖❖❖❖❖❖❖❖❖❖❖❖❖❖❖❖❖║❖❖❖❖❖❖❖❖❖❖❖❖❖❖❖❖❖❖❖❖ᆉᆉᆉᆉ❖❖║❖❖❖❖❖❖❖❖❖❖❖❖❖❖❖❖❖❖❖❖❖❖❖❖❖❖❖❖❖❖❖❖❖║❖❖❖❖❖❖❖❖❖❖❖❖❖❖❖❖❖❖❖❖❖❖❖❖❖❖❖❖❖❖❖❖❖❖❖❖❖❖❖❖❖❖❖❖❖❖❖❖❖❖❖❖❖❖❖❖❖❖❖❖❖❖❖❖❖❖❖❖║❖❖❖❖❖❖❖❖❖❖❖❖❖❖❖❖❖❖❖❖❖❖❖❖❖❖❖❖❖❖❖❖❖❖❖❖❖❖❖❖❖║
║ↁ❖❖❖❖❖❖☐☐✉✉║❖❖❖❖❖❖❖❖❖❖❖❖❖❖❖❖❖❖❖❖❖❖❖❖❖❖❖❖❖❖❖❖❖❖║❖☐❖ᆉ❖❖❖❖❖❖❖❖❖☐❖❖❖❖❖ᆉ❖❖❖❖❖❖║❖❖❖❖❖❖❖❖❖❖❖❖❖❖❖❖❖❖❖╔❖╗❖❖❖❖❖❖❖❖❖❖❖║❖❖❖❖❖❖❖❖❖❖❖❖❖❖❖❖❖❖❖❖❖❖❖❖❖❖❖❖❖❖❖❖❖❖❖❖❖❖❖❖❖❖❖❖❖❖❖❖❖❖❖❖❖❖❖❖❖❖❖❖❖❖❖❖❖❖❖❖║❖❖❖❖❖❖❖❖❖❖❖❖❖❖❖❖❖❖❖❖❖❖❖❖❖❖❖❖❖❖❖❖❖❖❖❖❖❖❖❖❖║
╚═══════════╩══════════════════════════════════╩══════════════════════════╩═══════════════════╝ ╚═══════════╩════════════════════════════════════════════════════════════════════╩═════════════════════════════════════════╝