╔═══════════════════════════════╗ ╔════════════════════════════════╗
║...............................╙.╜................................║
║..................................................................║
║......................................≈≈≈.........................║
║......................................≈≈≈.........................║
║......................................≈≈≈≈........................║
║.......................................≈≈≈........................║
║........................................≈........................╔╝
║.................................................................. 
║.................................................................╚╗
║.................1................................................║
║..................................................................║
║..................................................................║
║..................................................................║
║..................................................................║
║..................................................................║
║....................................╔═══════════╗.................║
║....................................║           ║.................║
║....................................║           ║.................║
║....................................║           ║.................║
╚════════════════════════════════════╝           ╚═════════════════╝
