╔════════════════════════════════════════════════════════════════════════════════════════════════════════════════════╗
║....................................................................................................................║
║....................................................................................................................║
║....................................................................................................................║
║....................................................................................................................║
║....................................................................................................................║
║....................................................................................................................║
║....................................................................................................................║
║....................................................................................................................║
║....................................................................................................................║
║....................................................................................................................║
║....................................................................................................................║
║....................................................................................................................║
║....................................................................................................................║
║....................................................................................................................║
║....................................................................................................................║
║...............................╔═══════════════════════════════════════════════════╗................................║
║...............................║                                                   ║................................║
║...............................║                                                   ║................................║
║...............................║                                                   ║................................║
║...............................║                                                   ║................................║
║...............................║                                                   ║................................║
║...............................║                                                   ║................................║
║...............................║                                                   ║................................║
║...............................║                                                   ║................................║
║...............................║                                                   ║................................║
║...............................║                                                   ║................................║
║...............................║                                                   ║................................║
║...............................║                                                   ║................................║
║...............................║                                                   ║................................║
║...............................║                                                   ║................................║
║...............................║                                                   ║................................║
║...............................║                                                   ║................................║
║...............................║                                                   ║................................║
║...............................║                                                   ║................................║
║...............................║                                                   ║................................║
║...............................║                                                   ║................................║
║...............................║                                                   ║................................║
║...............................║                                                   ║................................║
║...............................╚═══════════════════════════════════════════════════╝................................║
║....................................................................................................................║
║....................................................................................................................║
║....................................................................................................................║
║....................................................................................................................║
║....................................................................................................................║
║....................................................................................................................║
║....................................................................................................................║
║....................................................................................................................║
║....................................................................................................................║
║....................................................................................................................║
║....................................................................................................................║
║....................................................................................................................║
║....................................................................................................................║
║....................................................................................................................║
║.........................................................╓.╖........................................................║
╚═════════════════════════════════════════════════════════╝ ╚════════════════════════════════════════════════════════╝