╔══════════════════════════════════════════════════════════════════╗
║..................................................................║
║..................................5...............................║
║..........................❀.......................................║
║.......1..........................................................║
╚..................................................................║
a..................................................................║
╔..................................................................║
║..................................................................║
║..................................................................║
║...............7......................≈≈≈.........................║
║......................................≈≈≈.........................║
║......................................≈≈≈≈........................║
║.......................................≈≈≈........................║
║...............8........................≈.........................║
║..................................................................║
║..........................❀.......................................║
║..................................................................║
║..................................................................║
║..................................................................║
║..................................................................║
║....................................................3.............║
║......................9...........................................║
║......................................≈≈≈.........................║
║......................................≈≈≈.........................║
║............2.........................≈≈≈≈........................║
║.......................................≈≈≈........................║
║........................................≈.........................║
║..................................................................║
║..................................................................║
║....................................................4.............║
║..................................................................║
║..................................................................║
║...............................╓6╖................................║
╚═══════════════════════════════╝ ╚════════════════════════════════╝
